amplitude,noise_filter,band_pass,window_size,density,location,condition,method,total,total_P,TP,FP,total_N,TN,FN,precision
4020,0.1,True,0.004,86,True,baseline,w,3500,18,10,8,3510,2456,1054,0.5555555555555556
4020,0.1,True,0.004,86,True,vs_right,w,3500,350,334,16,3178,2448,730,0.9542857142857143
4020,0.1,True,0.004,86,True,vs_left,w,3500,361,351,10,3167,2454,713,0.9722991689750693
4020,0.1,True,0.004,86,True,difference,w,3500,9,7,2,3519,2462,1057,0.7777777777777778
4020,0.1,True,0.004,86,False,baseline,w,10750,16,7,9,10820,9763,1057,0.4375
4020,0.1,True,0.004,86,False,vs_right,w,10750,439,286,153,10397,9619,778,0.6514806378132119
4020,0.1,True,0.004,86,False,vs_left,w,10750,436,312,124,10400,9648,752,0.7155963302752294
4020,0.1,True,0.004,86,False,difference,w,10750,15,4,11,10821,9761,1060,0.26666666666666666
4020,0.1,True,0.004,64,True,baseline,w,2250,12,10,2,2256,1582,674,0.8333333333333334
4020,0.1,True,0.004,64,True,vs_right,w,2250,270,256,14,1998,1570,428,0.9481481481481482
4020,0.1,True,0.004,64,True,vs_left,w,2250,274,265,9,1994,1575,419,0.9671532846715328
4020,0.1,True,0.004,64,True,difference,w,2250,7,4,3,2261,1581,680,0.5714285714285714
4020,0.1,True,0.004,64,False,baseline,w,8000,19,7,12,8045,7368,677,0.3684210526315789
4020,0.1,True,0.004,64,False,vs_right,w,8000,360,221,139,7704,7241,463,0.6138888888888889
4020,0.1,True,0.004,64,False,vs_left,w,8000,337,234,103,7727,7277,450,0.6943620178041543
4020,0.1,True,0.004,64,False,difference,w,8000,13,4,9,8051,7371,680,0.3076923076923077
4020,0.1,True,0.004,31,True,baseline,w,1000,11,8,3,997,701,296,0.7272727272727273
4020,0.1,True,0.004,31,True,vs_right,w,1000,131,122,9,877,695,182,0.9312977099236641
4020,0.1,True,0.004,31,True,vs_left,w,1000,134,126,8,874,696,178,0.9402985074626866
4020,0.1,True,0.004,31,True,difference,w,1000,6,4,2,1002,702,300,0.6666666666666666
4020,0.1,True,0.004,31,False,baseline,w,3875,15,8,7,3891,3595,296,0.5333333333333333
4020,0.1,True,0.004,31,False,vs_right,w,3875,188,110,78,3718,3524,194,0.5851063829787234
4020,0.1,True,0.004,31,False,vs_left,w,3875,171,107,64,3735,3538,197,0.6257309941520468
4020,0.1,True,0.004,31,False,difference,w,3875,9,0,9,3897,3593,304,0.0
4020,0.1,True,0.012,86,True,baseline,w,1148,2,2,0,1174,840,334,1.0
4020,0.1,True,0.012,86,True,vs_right,w,1148,118,118,0,1058,840,218,1.0
4020,0.1,True,0.012,86,True,vs_left,w,1148,130,126,4,1046,836,210,0.9692307692307692
4020,0.1,True,0.012,86,True,difference,w,1148,0,0,0,1176,840,336,0.0
4020,0.1,True,0.012,86,False,baseline,w,3526,2,2,0,3610,3276,334,1.0
4020,0.1,True,0.012,86,False,vs_right,w,3526,148,103,45,3464,3231,233,0.6959459459459459
4020,0.1,True,0.012,86,False,vs_left,w,3526,143,112,31,3469,3245,224,0.7832167832167832
4020,0.1,True,0.012,86,False,difference,w,3526,2,0,2,3610,3274,336,0.0
4020,0.1,True,0.012,64,True,baseline,w,738,2,2,0,754,540,214,1.0
4020,0.1,True,0.012,64,True,vs_right,w,738,94,94,0,662,540,122,1.0
4020,0.1,True,0.012,64,True,vs_left,w,738,101,99,2,655,538,117,0.9801980198019802
4020,0.1,True,0.012,64,True,difference,w,738,2,2,0,754,540,214,1.0
4020,0.1,True,0.012,64,False,baseline,w,2624,2,2,0,2686,2472,214,1.0
4020,0.1,True,0.012,64,False,vs_right,w,2624,119,79,40,2569,2432,137,0.6638655462184874
4020,0.1,True,0.012,64,False,vs_left,w,2624,110,83,27,2578,2445,133,0.7545454545454545
4020,0.1,True,0.012,64,False,difference,w,2624,2,0,2,2686,2470,216,0.0
4020,0.1,True,0.012,31,True,baseline,w,328,4,4,0,332,240,92,1.0
4020,0.1,True,0.012,31,True,vs_right,w,328,44,41,3,292,237,55,0.9318181818181818
4020,0.1,True,0.012,31,True,vs_left,w,328,46,45,1,290,239,51,0.9782608695652174
4020,0.1,True,0.012,31,True,difference,w,328,2,2,0,334,240,94,1.0
4020,0.1,True,0.012,31,False,baseline,w,1271,2,2,0,1300,1206,94,1.0
4020,0.1,True,0.012,31,False,vs_right,w,1271,58,37,21,1244,1185,59,0.6379310344827587
4020,0.1,True,0.012,31,False,vs_left,w,1271,51,38,13,1251,1193,58,0.7450980392156863
4020,0.1,True,0.012,31,False,difference,w,1271,2,0,2,1300,1204,96,0.0
4020,0.1,True,0.02,86,True,baseline,w,700,0,0,0,728,504,224,0.0
4020,0.1,True,0.02,86,True,vs_right,w,700,69,69,0,659,504,155,1.0
4020,0.1,True,0.02,86,True,vs_left,w,700,65,64,1,663,503,160,0.9846153846153847
4020,0.1,True,0.02,86,True,difference,w,700,0,0,0,728,504,224,0.0
4020,0.1,True,0.02,86,False,baseline,w,2150,0,0,0,2236,2012,224,0.0
4020,0.1,True,0.02,86,False,vs_right,w,2150,67,60,7,2169,2005,164,0.8955223880597015
4020,0.1,True,0.02,86,False,vs_left,w,2150,65,56,9,2171,2003,168,0.8615384615384616
4020,0.1,True,0.02,86,False,difference,w,2150,0,0,0,2236,2012,224,0.0
4020,0.1,True,0.02,64,True,baseline,w,450,2,2,0,466,324,142,1.0
4020,0.1,True,0.02,64,True,vs_right,w,450,52,52,0,416,324,92,1.0
4020,0.1,True,0.02,64,True,vs_left,w,450,51,50,1,417,323,94,0.9803921568627451
4020,0.1,True,0.02,64,True,difference,w,450,0,0,0,468,324,144,0.0
4020,0.1,True,0.02,64,False,baseline,w,1600,0,0,0,1664,1520,144,0.0
4020,0.1,True,0.02,64,False,vs_right,w,1600,55,48,7,1609,1513,96,0.8727272727272727
4020,0.1,True,0.02,64,False,vs_left,w,1600,52,43,9,1612,1511,101,0.8269230769230769
4020,0.1,True,0.02,64,False,difference,w,1600,2,0,2,1662,1518,144,0.0
4020,0.1,True,0.02,31,True,baseline,w,200,4,4,0,204,144,60,1.0
4020,0.1,True,0.02,31,True,vs_right,w,200,28,26,2,180,142,38,0.9285714285714286
4020,0.1,True,0.02,31,True,vs_left,w,200,27,27,0,181,144,37,1.0
4020,0.1,True,0.02,31,True,difference,w,200,0,0,0,208,144,64,0.0
4020,0.1,True,0.02,31,False,baseline,w,775,0,0,0,806,742,64,0.0
4020,0.1,True,0.02,31,False,vs_right,w,775,23,21,2,783,740,43,0.9130434782608695
4020,0.1,True,0.02,31,False,vs_left,w,775,19,19,0,787,742,45,1.0
4020,0.1,True,0.02,31,False,difference,w,775,0,0,0,806,742,64,0.0
4020,0.1,True,0.004,86,True,baseline,b,3500,0,0,0,3528,2464,1064,0.0
4020,0.1,True,0.004,86,True,vs_right,b,3500,34,34,0,3494,2464,1030,1.0
4020,0.1,True,0.004,86,True,vs_left,b,3500,28,28,0,3500,2464,1036,1.0
4020,0.1,True,0.004,86,True,difference,b,3500,0,0,0,3528,2464,1064,0.0
4020,0.1,True,0.004,86,False,baseline,b,10750,0,0,0,10836,9772,1064,0.0
4020,0.1,True,0.004,86,False,vs_right,b,10750,14,11,3,10822,9769,1053,0.7857142857142857
4020,0.1,True,0.004,86,False,vs_left,b,10750,12,11,1,10824,9771,1053,0.9166666666666666
4020,0.1,True,0.004,86,False,difference,b,10750,0,0,0,10836,9772,1064,0.0
4020,0.1,True,0.004,64,True,baseline,b,2250,0,0,0,2268,1584,684,0.0
4020,0.1,True,0.004,64,True,vs_right,b,2250,33,33,0,2235,1584,651,1.0
4020,0.1,True,0.004,64,True,vs_left,b,2250,32,32,0,2236,1584,652,1.0
4020,0.1,True,0.004,64,True,difference,b,2250,0,0,0,2268,1584,684,0.0
4020,0.1,True,0.004,64,False,baseline,b,8000,0,0,0,8064,7380,684,0.0
4020,0.1,True,0.004,64,False,vs_right,b,8000,15,11,4,8049,7376,673,0.7333333333333333
4020,0.1,True,0.004,64,False,vs_left,b,8000,11,11,0,8053,7380,673,1.0
4020,0.1,True,0.004,64,False,difference,b,8000,0,0,0,8064,7380,684,0.0
4020,0.1,True,0.004,31,True,baseline,b,1000,0,0,0,1008,704,304,0.0
4020,0.1,True,0.004,31,True,vs_right,b,1000,25,25,0,983,704,279,1.0
4020,0.1,True,0.004,31,True,vs_left,b,1000,31,31,0,977,704,273,1.0
4020,0.1,True,0.004,31,True,difference,b,1000,0,0,0,1008,704,304,0.0
4020,0.1,True,0.004,31,False,baseline,b,3875,0,0,0,3906,3602,304,0.0
4020,0.1,True,0.004,31,False,vs_right,b,3875,13,11,2,3893,3600,293,0.8461538461538461
4020,0.1,True,0.004,31,False,vs_left,b,3875,14,14,0,3892,3602,290,1.0
4020,0.1,True,0.004,31,False,difference,b,3875,0,0,0,3906,3602,304,0.0
4020,0.1,True,0.012,86,True,baseline,b,1148,0,0,0,1176,840,336,0.0
4020,0.1,True,0.012,86,True,vs_right,b,1148,25,25,0,1151,840,311,1.0
4020,0.1,True,0.012,86,True,vs_left,b,1148,24,24,0,1152,840,312,1.0
4020,0.1,True,0.012,86,True,difference,b,1148,0,0,0,1176,840,336,0.0
4020,0.1,True,0.012,86,False,baseline,b,3526,0,0,0,3612,3276,336,0.0
4020,0.1,True,0.012,86,False,vs_right,b,3526,14,13,1,3598,3275,323,0.9285714285714286
4020,0.1,True,0.012,86,False,vs_left,b,3526,10,9,1,3602,3275,327,0.9
4020,0.1,True,0.012,86,False,difference,b,3526,0,0,0,3612,3276,336,0.0
4020,0.1,True,0.012,64,True,baseline,b,738,0,0,0,756,540,216,0.0
4020,0.1,True,0.012,64,True,vs_right,b,738,21,21,0,735,540,195,1.0
4020,0.1,True,0.012,64,True,vs_left,b,738,24,24,0,732,540,192,1.0
4020,0.1,True,0.012,64,True,difference,b,738,0,0,0,756,540,216,0.0
4020,0.1,True,0.012,64,False,baseline,b,2624,0,0,0,2688,2472,216,0.0
4020,0.1,True,0.012,64,False,vs_right,b,2624,11,10,1,2677,2471,206,0.9090909090909091
4020,0.1,True,0.012,64,False,vs_left,b,2624,9,9,0,2679,2472,207,1.0
4020,0.1,True,0.012,64,False,difference,b,2624,0,0,0,2688,2472,216,0.0
4020,0.1,True,0.012,31,True,baseline,b,328,0,0,0,336,240,96,0.0
4020,0.1,True,0.012,31,True,vs_right,b,328,12,12,0,324,240,84,1.0
4020,0.1,True,0.012,31,True,vs_left,b,328,15,15,0,321,240,81,1.0
4020,0.1,True,0.012,31,True,difference,b,328,0,0,0,336,240,96,0.0
4020,0.1,True,0.012,31,False,baseline,b,1271,0,0,0,1302,1206,96,0.0
4020,0.1,True,0.012,31,False,vs_right,b,1271,10,8,2,1292,1204,88,0.8
4020,0.1,True,0.012,31,False,vs_left,b,1271,12,12,0,1290,1206,84,1.0
4020,0.1,True,0.012,31,False,difference,b,1271,0,0,0,1302,1206,96,0.0
4020,0.1,True,0.02,86,True,baseline,b,700,0,0,0,728,504,224,0.0
4020,0.1,True,0.02,86,True,vs_right,b,700,22,22,0,706,504,202,1.0
4020,0.1,True,0.02,86,True,vs_left,b,700,21,21,0,707,504,203,1.0
4020,0.1,True,0.02,86,True,difference,b,700,0,0,0,728,504,224,0.0
4020,0.1,True,0.02,86,False,baseline,b,2150,0,0,0,2236,2012,224,0.0
4020,0.1,True,0.02,86,False,vs_right,b,2150,13,10,3,2223,2009,214,0.7692307692307693
4020,0.1,True,0.02,86,False,vs_left,b,2150,11,11,0,2225,2012,213,1.0
4020,0.1,True,0.02,86,False,difference,b,2150,0,0,0,2236,2012,224,0.0
4020,0.1,True,0.02,64,True,baseline,b,450,0,0,0,468,324,144,0.0
4020,0.1,True,0.02,64,True,vs_right,b,450,15,15,0,453,324,129,1.0
4020,0.1,True,0.02,64,True,vs_left,b,450,18,18,0,450,324,126,1.0
4020,0.1,True,0.02,64,True,difference,b,450,0,0,0,468,324,144,0.0
4020,0.1,True,0.02,64,False,baseline,b,1600,0,0,0,1664,1520,144,0.0
4020,0.1,True,0.02,64,False,vs_right,b,1600,12,9,3,1652,1517,135,0.75
4020,0.1,True,0.02,64,False,vs_left,b,1600,9,9,0,1655,1520,135,1.0
4020,0.1,True,0.02,64,False,difference,b,1600,0,0,0,1664,1520,144,0.0
4020,0.1,True,0.02,31,True,baseline,b,200,0,0,0,208,144,64,0.0
4020,0.1,True,0.02,31,True,vs_right,b,200,10,10,0,198,144,54,1.0
4020,0.1,True,0.02,31,True,vs_left,b,200,10,10,0,198,144,54,1.0
4020,0.1,True,0.02,31,True,difference,b,200,0,0,0,208,144,64,0.0
4020,0.1,True,0.02,31,False,baseline,b,775,0,0,0,806,742,64,0.0
4020,0.1,True,0.02,31,False,vs_right,b,775,8,7,1,798,741,57,0.875
4020,0.1,True,0.02,31,False,vs_left,b,775,6,6,0,800,742,58,1.0
4020,0.1,True,0.02,31,False,difference,b,775,0,0,0,806,742,64,0.0
4020,0.1,False,0.004,86,True,baseline,w,3500,2,0,2,3526,2462,1064,0.0
4020,0.1,False,0.004,86,True,vs_right,w,3500,327,310,17,3201,2447,754,0.9480122324159022
4020,0.1,False,0.004,86,True,vs_left,w,3500,315,315,0,3213,2464,749,1.0
4020,0.1,False,0.004,86,True,difference,w,3500,13,3,10,3515,2454,1061,0.23076923076923078
4020,0.1,False,0.004,86,False,baseline,w,10750,10,0,10,10826,9762,1064,0.0
4020,0.1,False,0.004,86,False,vs_right,w,10750,379,276,103,10457,9669,788,0.7282321899736148
4020,0.1,False,0.004,86,False,vs_left,w,10750,377,263,114,10459,9658,801,0.6976127320954907
4020,0.1,False,0.004,86,False,difference,w,10750,15,3,12,10821,9760,1061,0.2
4020,0.1,False,0.004,64,True,baseline,w,2250,2,0,2,2266,1582,684,0.0
4020,0.1,False,0.004,64,True,vs_right,w,2250,264,252,12,2004,1572,432,0.9545454545454546
4020,0.1,False,0.004,64,True,vs_left,w,2250,231,231,0,2037,1584,453,1.0
4020,0.1,False,0.004,64,True,difference,w,2250,17,5,12,2251,1572,679,0.29411764705882354
4020,0.1,False,0.004,64,False,baseline,w,8000,11,0,11,8053,7369,684,0.0
4020,0.1,False,0.004,64,False,vs_right,w,8000,290,216,74,7774,7306,468,0.7448275862068966
4020,0.1,False,0.004,64,False,vs_left,w,8000,302,194,108,7762,7272,490,0.6423841059602649
4020,0.1,False,0.004,64,False,difference,w,8000,12,3,9,8052,7371,681,0.25
4020,0.1,False,0.004,31,True,baseline,w,1000,2,0,2,1006,702,304,0.0
4020,0.1,False,0.004,31,True,vs_right,w,1000,122,109,13,886,691,195,0.8934426229508197
4020,0.1,False,0.004,31,True,vs_left,w,1000,112,110,2,896,702,194,0.9821428571428571
4020,0.1,False,0.004,31,True,difference,w,1000,17,4,13,991,691,300,0.23529411764705882
4020,0.1,False,0.004,31,False,baseline,w,3875,8,0,8,3898,3594,304,0.0
4020,0.1,False,0.004,31,False,vs_right,w,3875,144,102,42,3762,3560,202,0.7083333333333334
4020,0.1,False,0.004,31,False,vs_left,w,3875,156,84,72,3750,3530,220,0.5384615384615384
4020,0.1,False,0.004,31,False,difference,w,3875,11,3,8,3895,3594,301,0.2727272727272727
4020,0.1,False,0.012,86,True,baseline,w,1148,0,0,0,1176,840,336,0.0
4020,0.1,False,0.012,86,True,vs_right,w,1148,109,107,2,1067,838,229,0.981651376146789
4020,0.1,False,0.012,86,True,vs_left,w,1148,110,109,1,1066,839,227,0.990909090909091
4020,0.1,False,0.012,86,True,difference,w,1148,4,0,4,1172,836,336,0.0
4020,0.1,False,0.012,86,False,baseline,w,3526,2,0,2,3610,3274,336,0.0
4020,0.1,False,0.012,86,False,vs_right,w,3526,136,104,32,3476,3244,232,0.7647058823529411
4020,0.1,False,0.012,86,False,vs_left,w,3526,128,93,35,3484,3241,243,0.7265625
4020,0.1,False,0.012,86,False,difference,w,3526,2,0,2,3610,3274,336,0.0
4020,0.1,False,0.012,64,True,baseline,w,738,0,0,0,756,540,216,0.0
4020,0.1,False,0.012,64,True,vs_right,w,738,87,85,2,669,538,131,0.9770114942528736
4020,0.1,False,0.012,64,True,vs_left,w,738,83,83,0,673,540,133,1.0
4020,0.1,False,0.012,64,True,difference,w,738,2,0,2,754,538,216,0.0
4020,0.1,False,0.012,64,False,baseline,w,2624,2,0,2,2686,2470,216,0.0
4020,0.1,False,0.012,64,False,vs_right,w,2624,106,80,26,2582,2446,136,0.7547169811320755
4020,0.1,False,0.012,64,False,vs_left,w,2624,102,68,34,2586,2438,148,0.6666666666666666
4020,0.1,False,0.012,64,False,difference,w,2624,2,0,2,2686,2470,216,0.0
4020,0.1,False,0.012,31,True,baseline,w,328,0,0,0,336,240,96,0.0
4020,0.1,False,0.012,31,True,vs_right,w,328,38,36,2,298,238,60,0.9473684210526315
4020,0.1,False,0.012,31,True,vs_left,w,328,38,38,0,298,240,58,1.0
4020,0.1,False,0.012,31,True,difference,w,328,2,0,2,334,238,96,0.0
4020,0.1,False,0.012,31,False,baseline,w,1271,2,0,2,1300,1204,96,0.0
4020,0.1,False,0.012,31,False,vs_right,w,1271,44,33,11,1258,1195,63,0.75
4020,0.1,False,0.012,31,False,vs_left,w,1271,53,31,22,1249,1184,65,0.5849056603773585
4020,0.1,False,0.012,31,False,difference,w,1271,2,0,2,1300,1204,96,0.0
4020,0.1,False,0.02,86,True,baseline,w,700,0,0,0,728,504,224,0.0
4020,0.1,False,0.02,86,True,vs_right,w,700,63,61,2,665,502,163,0.9682539682539683
4020,0.1,False,0.02,86,True,vs_left,w,700,57,57,0,671,504,167,1.0
4020,0.1,False,0.02,86,True,difference,w,700,0,0,0,728,504,224,0.0
4020,0.1,False,0.02,86,False,baseline,w,2150,0,0,0,2236,2012,224,0.0
4020,0.1,False,0.02,86,False,vs_right,w,2150,70,53,17,2166,1995,171,0.7571428571428571
4020,0.1,False,0.02,86,False,vs_left,w,2150,49,39,10,2187,2002,185,0.7959183673469388
4020,0.1,False,0.02,86,False,difference,w,2150,0,0,0,2236,2012,224,0.0
4020,0.1,False,0.02,64,True,baseline,w,450,0,0,0,468,324,144,0.0
4020,0.1,False,0.02,64,True,vs_right,w,450,48,48,0,420,324,96,1.0
4020,0.1,False,0.02,64,True,vs_left,w,450,42,42,0,426,324,102,1.0
4020,0.1,False,0.02,64,True,difference,w,450,0,0,0,468,324,144,0.0
4020,0.1,False,0.02,64,False,baseline,w,1600,0,0,0,1664,1520,144,0.0
4020,0.1,False,0.02,64,False,vs_right,w,1600,54,43,11,1610,1509,101,0.7962962962962963
4020,0.1,False,0.02,64,False,vs_left,w,1600,37,27,10,1627,1510,117,0.7297297297297297
4020,0.1,False,0.02,64,False,difference,w,1600,0,0,0,1664,1520,144,0.0
4020,0.1,False,0.02,31,True,baseline,w,200,0,0,0,208,144,64,0.0
4020,0.1,False,0.02,31,True,vs_right,w,200,24,22,2,184,142,42,0.9166666666666666
4020,0.1,False,0.02,31,True,vs_left,w,200,23,23,0,185,144,41,1.0
4020,0.1,False,0.02,31,True,difference,w,200,0,0,0,208,144,64,0.0
4020,0.1,False,0.02,31,False,baseline,w,775,0,0,0,806,742,64,0.0
4020,0.1,False,0.02,31,False,vs_right,w,775,27,21,6,779,736,43,0.7777777777777778
4020,0.1,False,0.02,31,False,vs_left,w,775,32,22,10,774,732,42,0.6875
4020,0.1,False,0.02,31,False,difference,w,775,0,0,0,806,742,64,0.0
4020,0.1,False,0.004,86,True,baseline,b,3500,0,0,0,3528,2464,1064,0.0
4020,0.1,False,0.004,86,True,vs_right,b,3500,33,33,0,3495,2464,1031,1.0
4020,0.1,False,0.004,86,True,vs_left,b,3500,19,19,0,3509,2464,1045,1.0
4020,0.1,False,0.004,86,True,difference,b,3500,0,0,0,3528,2464,1064,0.0
4020,0.1,False,0.004,86,False,baseline,b,10750,0,0,0,10836,9772,1064,0.0
4020,0.1,False,0.004,86,False,vs_right,b,10750,16,15,1,10820,9771,1049,0.9375
4020,0.1,False,0.004,86,False,vs_left,b,10750,12,9,3,10824,9769,1055,0.75
4020,0.1,False,0.004,86,False,difference,b,10750,0,0,0,10836,9772,1064,0.0
4020,0.1,False,0.004,64,True,baseline,b,2250,0,0,0,2268,1584,684,0.0
4020,0.1,False,0.004,64,True,vs_right,b,2250,28,28,0,2240,1584,656,1.0
4020,0.1,False,0.004,64,True,vs_left,b,2250,16,16,0,2252,1584,668,1.0
4020,0.1,False,0.004,64,True,difference,b,2250,0,0,0,2268,1584,684,0.0
4020,0.1,False,0.004,64,False,baseline,b,8000,0,0,0,8064,7380,684,0.0
4020,0.1,False,0.004,64,False,vs_right,b,8000,10,9,1,8054,7379,675,0.9
4020,0.1,False,0.004,64,False,vs_left,b,8000,11,8,3,8053,7377,676,0.7272727272727273
4020,0.1,False,0.004,64,False,difference,b,8000,0,0,0,8064,7380,684,0.0
4020,0.1,False,0.004,31,True,baseline,b,1000,0,0,0,1008,704,304,0.0
4020,0.1,False,0.004,31,True,vs_right,b,1000,21,21,0,987,704,283,1.0
4020,0.1,False,0.004,31,True,vs_left,b,1000,17,17,0,991,704,287,1.0
4020,0.1,False,0.004,31,True,difference,b,1000,0,0,0,1008,704,304,0.0
4020,0.1,False,0.004,31,False,baseline,b,3875,0,0,0,3906,3602,304,0.0
4020,0.1,False,0.004,31,False,vs_right,b,3875,9,9,0,3897,3602,295,1.0
4020,0.1,False,0.004,31,False,vs_left,b,3875,13,8,5,3893,3597,296,0.6153846153846154
4020,0.1,False,0.004,31,False,difference,b,3875,0,0,0,3906,3602,304,0.0
4020,0.1,False,0.012,86,True,baseline,b,1148,0,0,0,1176,840,336,0.0
4020,0.1,False,0.012,86,True,vs_right,b,1148,20,20,0,1156,840,316,1.0
4020,0.1,False,0.012,86,True,vs_left,b,1148,16,16,0,1160,840,320,1.0
4020,0.1,False,0.012,86,True,difference,b,1148,0,0,0,1176,840,336,0.0
4020,0.1,False,0.012,86,False,baseline,b,3526,0,0,0,3612,3276,336,0.0
4020,0.1,False,0.012,86,False,vs_right,b,3526,9,8,1,3603,3275,328,0.8888888888888888
4020,0.1,False,0.012,86,False,vs_left,b,3526,9,8,1,3603,3275,328,0.8888888888888888
4020,0.1,False,0.012,86,False,difference,b,3526,0,0,0,3612,3276,336,0.0
4020,0.1,False,0.012,64,True,baseline,b,738,0,0,0,756,540,216,0.0
4020,0.1,False,0.012,64,True,vs_right,b,738,18,18,0,738,540,198,1.0
4020,0.1,False,0.012,64,True,vs_left,b,738,16,16,0,740,540,200,1.0
4020,0.1,False,0.012,64,True,difference,b,738,0,0,0,756,540,216,0.0
4020,0.1,False,0.012,64,False,baseline,b,2624,0,0,0,2688,2472,216,0.0
4020,0.1,False,0.012,64,False,vs_right,b,2624,7,7,0,2681,2472,209,1.0
4020,0.1,False,0.012,64,False,vs_left,b,2624,8,7,1,2680,2471,209,0.875
4020,0.1,False,0.012,64,False,difference,b,2624,0,0,0,2688,2472,216,0.0
4020,0.1,False,0.012,31,True,baseline,b,328,0,0,0,336,240,96,0.0
4020,0.1,False,0.012,31,True,vs_right,b,328,12,12,0,324,240,84,1.0
4020,0.1,False,0.012,31,True,vs_left,b,328,12,12,0,324,240,84,1.0
4020,0.1,False,0.012,31,True,difference,b,328,0,0,0,336,240,96,0.0
4020,0.1,False,0.012,31,False,baseline,b,1271,0,0,0,1302,1206,96,0.0
4020,0.1,False,0.012,31,False,vs_right,b,1271,8,8,0,1294,1206,88,1.0
4020,0.1,False,0.012,31,False,vs_left,b,1271,6,4,2,1296,1204,92,0.6666666666666666
4020,0.1,False,0.012,31,False,difference,b,1271,0,0,0,1302,1206,96,0.0
4020,0.1,False,0.02,86,True,baseline,b,700,0,0,0,728,504,224,0.0
4020,0.1,False,0.02,86,True,vs_right,b,700,17,17,0,711,504,207,1.0
4020,0.1,False,0.02,86,True,vs_left,b,700,17,17,0,711,504,207,1.0
4020,0.1,False,0.02,86,True,difference,b,700,0,0,0,728,504,224,0.0
4020,0.1,False,0.02,86,False,baseline,b,2150,0,0,0,2236,2012,224,0.0
4020,0.1,False,0.02,86,False,vs_right,b,2150,9,9,0,2227,2012,215,1.0
4020,0.1,False,0.02,86,False,vs_left,b,2150,8,6,2,2228,2010,218,0.75
4020,0.1,False,0.02,86,False,difference,b,2150,0,0,0,2236,2012,224,0.0
4020,0.1,False,0.02,64,True,baseline,b,450,0,0,0,468,324,144,0.0
4020,0.1,False,0.02,64,True,vs_right,b,450,15,15,0,453,324,129,1.0
4020,0.1,False,0.02,64,True,vs_left,b,450,15,15,0,453,324,129,1.0
4020,0.1,False,0.02,64,True,difference,b,450,0,0,0,468,324,144,0.0
4020,0.1,False,0.02,64,False,baseline,b,1600,0,0,0,1664,1520,144,0.0
4020,0.1,False,0.02,64,False,vs_right,b,1600,8,8,0,1656,1520,136,1.0
4020,0.1,False,0.02,64,False,vs_left,b,1600,7,5,2,1657,1518,139,0.7142857142857143
4020,0.1,False,0.02,64,False,difference,b,1600,0,0,0,1664,1520,144,0.0
4020,0.1,False,0.02,31,True,baseline,b,200,0,0,0,208,144,64,0.0
4020,0.1,False,0.02,31,True,vs_right,b,200,11,10,1,197,143,54,0.9090909090909091
4020,0.1,False,0.02,31,True,vs_left,b,200,8,8,0,200,144,56,1.0
4020,0.1,False,0.02,31,True,difference,b,200,0,0,0,208,144,64,0.0
4020,0.1,False,0.02,31,False,baseline,b,775,0,0,0,806,742,64,0.0
4020,0.1,False,0.02,31,False,vs_right,b,775,4,4,0,802,742,60,1.0
4020,0.1,False,0.02,31,False,vs_left,b,775,5,4,1,801,741,60,0.8
4020,0.1,False,0.02,31,False,difference,b,775,0,0,0,806,742,64,0.0
4020,0.2,True,0.004,86,True,baseline,w,3500,13,7,6,3515,2458,1057,0.5384615384615384
4020,0.2,True,0.004,86,True,vs_right,w,3500,472,439,33,3056,2431,625,0.9300847457627118
4020,0.2,True,0.004,86,True,vs_left,w,3500,457,449,8,3071,2456,615,0.9824945295404814
4020,0.2,True,0.004,86,True,difference,w,3500,4,0,4,3524,2460,1064,0.0
4020,0.2,True,0.004,86,False,baseline,w,10750,9,5,4,10827,9768,1059,0.5555555555555556
4020,0.2,True,0.004,86,False,vs_right,w,10750,889,391,498,9947,9274,673,0.4398200224971879
4020,0.2,True,0.004,86,False,vs_left,w,10750,889,399,490,9947,9282,665,0.44881889763779526
4020,0.2,True,0.004,86,False,difference,w,10750,7,0,7,10829,9765,1064,0.0
4020,0.2,True,0.004,64,True,baseline,w,2250,10,4,6,2258,1578,680,0.4
4020,0.2,True,0.004,64,True,vs_right,w,2250,365,334,31,1903,1553,350,0.915068493150685
4020,0.2,True,0.004,64,True,vs_left,w,2250,330,327,3,1938,1581,357,0.990909090909091
4020,0.2,True,0.004,64,True,difference,w,2250,3,0,3,2265,1581,684,0.0
4020,0.2,True,0.004,64,False,baseline,w,8000,11,3,8,8053,7372,681,0.2727272727272727
4020,0.2,True,0.004,64,False,vs_right,w,8000,703,297,406,7361,6974,387,0.422475106685633
4020,0.2,True,0.004,64,False,vs_left,w,8000,676,290,386,7388,6994,394,0.4289940828402367
4020,0.2,True,0.004,64,False,difference,w,8000,8,0,8,8056,7372,684,0.0
4020,0.2,True,0.004,31,True,baseline,w,1000,2,2,0,1006,704,302,1.0
4020,0.2,True,0.004,31,True,vs_right,w,1000,164,148,16,844,688,156,0.9024390243902439
4020,0.2,True,0.004,31,True,vs_left,w,1000,141,141,0,867,704,163,1.0
4020,0.2,True,0.004,31,True,difference,w,1000,7,2,5,1001,699,302,0.2857142857142857
4020,0.2,True,0.004,31,False,baseline,w,3875,6,0,6,3900,3596,304,0.0
4020,0.2,True,0.004,31,False,vs_right,w,3875,369,133,236,3537,3366,171,0.3604336043360434
4020,0.2,True,0.004,31,False,vs_left,w,3875,335,127,208,3571,3394,177,0.37910447761194027
4020,0.2,True,0.004,31,False,difference,w,3875,10,0,10,3896,3592,304,0.0
4020,0.2,True,0.012,86,True,baseline,w,1148,4,4,0,1172,840,332,1.0
4020,0.2,True,0.012,86,True,vs_right,w,1148,163,156,7,1013,833,180,0.9570552147239264
4020,0.2,True,0.012,86,True,vs_left,w,1148,167,165,2,1009,838,171,0.9880239520958084
4020,0.2,True,0.012,86,True,difference,w,1148,0,0,0,1176,840,336,0.0
4020,0.2,True,0.012,86,False,baseline,w,3526,2,2,0,3610,3276,334,1.0
4020,0.2,True,0.012,86,False,vs_right,w,3526,310,140,170,3302,3106,196,0.45161290322580644
4020,0.2,True,0.012,86,False,vs_left,w,3526,307,144,163,3305,3113,192,0.46905537459283386
4020,0.2,True,0.012,86,False,difference,w,3526,0,0,0,3612,3276,336,0.0
4020,0.2,True,0.012,64,True,baseline,w,738,2,2,0,754,540,214,1.0
4020,0.2,True,0.012,64,True,vs_right,w,738,117,114,3,639,537,102,0.9743589743589743
4020,0.2,True,0.012,64,True,vs_left,w,738,120,120,0,636,540,96,1.0
4020,0.2,True,0.012,64,True,difference,w,738,0,0,0,756,540,216,0.0
4020,0.2,True,0.012,64,False,baseline,w,2624,2,2,0,2686,2472,214,1.0
4020,0.2,True,0.012,64,False,vs_right,w,2624,243,105,138,2445,2334,111,0.43209876543209874
4020,0.2,True,0.012,64,False,vs_left,w,2624,234,104,130,2454,2342,112,0.4444444444444444
4020,0.2,True,0.012,64,False,difference,w,2624,1,0,1,2687,2471,216,0.0
4020,0.2,True,0.012,31,True,baseline,w,328,0,0,0,336,240,96,0.0
4020,0.2,True,0.012,31,True,vs_right,w,328,57,46,11,279,229,50,0.8070175438596491
4020,0.2,True,0.012,31,True,vs_left,w,328,53,53,0,283,240,43,1.0
4020,0.2,True,0.012,31,True,difference,w,328,0,0,0,336,240,96,0.0
4020,0.2,True,0.012,31,False,baseline,w,1271,1,0,1,1301,1205,96,0.0
4020,0.2,True,0.012,31,False,vs_right,w,1271,128,45,83,1174,1123,51,0.3515625
4020,0.2,True,0.012,31,False,vs_left,w,1271,121,47,74,1181,1132,49,0.3884297520661157
4020,0.2,True,0.012,31,False,difference,w,1271,0,0,0,1302,1206,96,0.0
4020,0.2,True,0.02,86,True,baseline,w,700,0,0,0,728,504,224,0.0
4020,0.2,True,0.02,86,True,vs_right,w,700,95,91,4,633,500,133,0.9578947368421052
4020,0.2,True,0.02,86,True,vs_left,w,700,86,86,0,642,504,138,1.0
4020,0.2,True,0.02,86,True,difference,w,700,0,0,0,728,504,224,0.0
4020,0.2,True,0.02,86,False,baseline,w,2150,0,0,0,2236,2012,224,0.0
4020,0.2,True,0.02,86,False,vs_right,w,2150,165,82,83,2071,1929,142,0.49696969696969695
4020,0.2,True,0.02,86,False,vs_left,w,2150,143,80,63,2093,1949,144,0.5594405594405595
4020,0.2,True,0.02,86,False,difference,w,2150,1,0,1,2235,2011,224,0.0
4020,0.2,True,0.02,64,True,baseline,w,450,0,0,0,468,324,144,0.0
4020,0.2,True,0.02,64,True,vs_right,w,450,73,67,6,395,318,77,0.9178082191780822
4020,0.2,True,0.02,64,True,vs_left,w,450,66,66,0,402,324,78,1.0
4020,0.2,True,0.02,64,True,difference,w,450,0,0,0,468,324,144,0.0
4020,0.2,True,0.02,64,False,baseline,w,1600,1,0,1,1663,1519,144,0.0
4020,0.2,True,0.02,64,False,vs_right,w,1600,132,62,70,1532,1450,82,0.4696969696969697
4020,0.2,True,0.02,64,False,vs_left,w,1600,110,58,52,1554,1468,86,0.5272727272727272
4020,0.2,True,0.02,64,False,difference,w,1600,1,0,1,1663,1519,144,0.0
4020,0.2,True,0.02,31,True,baseline,w,200,0,0,0,208,144,64,0.0
4020,0.2,True,0.02,31,True,vs_right,w,200,29,27,2,179,142,37,0.9310344827586207
4020,0.2,True,0.02,31,True,vs_left,w,200,32,32,0,176,144,32,1.0
4020,0.2,True,0.02,31,True,difference,w,200,0,0,0,208,144,64,0.0
4020,0.2,True,0.02,31,False,baseline,w,775,1,0,1,805,741,64,0.0
4020,0.2,True,0.02,31,False,vs_right,w,775,71,26,45,735,697,38,0.36619718309859156
4020,0.2,True,0.02,31,False,vs_left,w,775,60,27,33,746,709,37,0.45
4020,0.2,True,0.02,31,False,difference,w,775,0,0,0,806,742,64,0.0
4020,0.2,True,0.004,86,True,baseline,b,3500,0,0,0,3528,2464,1064,0.0
4020,0.2,True,0.004,86,True,vs_right,b,3500,41,40,1,3487,2463,1024,0.975609756097561
4020,0.2,True,0.004,86,True,vs_left,b,3500,30,30,0,3498,2464,1034,1.0
4020,0.2,True,0.004,86,True,difference,b,3500,0,0,0,3528,2464,1064,0.0
4020,0.2,True,0.004,86,False,baseline,b,10750,0,0,0,10836,9772,1064,0.0
4020,0.2,True,0.004,86,False,vs_right,b,10750,12,6,6,10824,9766,1058,0.5
4020,0.2,True,0.004,86,False,vs_left,b,10750,19,3,16,10817,9756,1061,0.15789473684210525
4020,0.2,True,0.004,86,False,difference,b,10750,0,0,0,10836,9772,1064,0.0
4020,0.2,True,0.004,64,True,baseline,b,2250,0,0,0,2268,1584,684,0.0
4020,0.2,True,0.004,64,True,vs_right,b,2250,53,51,2,2215,1582,633,0.9622641509433962
4020,0.2,True,0.004,64,True,vs_left,b,2250,38,38,0,2230,1584,646,1.0
4020,0.2,True,0.004,64,True,difference,b,2250,0,0,0,2268,1584,684,0.0
4020,0.2,True,0.004,64,False,baseline,b,8000,0,0,0,8064,7380,684,0.0
4020,0.2,True,0.004,64,False,vs_right,b,8000,22,13,9,8042,7371,671,0.5909090909090909
4020,0.2,True,0.004,64,False,vs_left,b,8000,17,4,13,8047,7367,680,0.23529411764705882
4020,0.2,True,0.004,64,False,difference,b,8000,0,0,0,8064,7380,684,0.0
4020,0.2,True,0.004,31,True,baseline,b,1000,0,0,0,1008,704,304,0.0
4020,0.2,True,0.004,31,True,vs_right,b,1000,36,36,0,972,704,268,1.0
4020,0.2,True,0.004,31,True,vs_left,b,1000,36,36,0,972,704,268,1.0
4020,0.2,True,0.004,31,True,difference,b,1000,0,0,0,1008,704,304,0.0
4020,0.2,True,0.004,31,False,baseline,b,3875,0,0,0,3906,3602,304,0.0
4020,0.2,True,0.004,31,False,vs_right,b,3875,26,16,10,3880,3592,288,0.6153846153846154
4020,0.2,True,0.004,31,False,vs_left,b,3875,13,6,7,3893,3595,298,0.46153846153846156
4020,0.2,True,0.004,31,False,difference,b,3875,0,0,0,3906,3602,304,0.0
4020,0.2,True,0.012,86,True,baseline,b,1148,0,0,0,1176,840,336,0.0
4020,0.2,True,0.012,86,True,vs_right,b,1148,31,31,0,1145,840,305,1.0
4020,0.2,True,0.012,86,True,vs_left,b,1148,43,43,0,1133,840,293,1.0
4020,0.2,True,0.012,86,True,difference,b,1148,0,0,0,1176,840,336,0.0
4020,0.2,True,0.012,86,False,baseline,b,3526,0,0,0,3612,3276,336,0.0
4020,0.2,True,0.012,86,False,vs_right,b,3526,19,11,8,3593,3268,325,0.5789473684210527
4020,0.2,True,0.012,86,False,vs_left,b,3526,18,7,11,3594,3265,329,0.3888888888888889
4020,0.2,True,0.012,86,False,difference,b,3526,0,0,0,3612,3276,336,0.0
4020,0.2,True,0.012,64,True,baseline,b,738,0,0,0,756,540,216,0.0
4020,0.2,True,0.012,64,True,vs_right,b,738,28,28,0,728,540,188,1.0
4020,0.2,True,0.012,64,True,vs_left,b,738,37,37,0,719,540,179,1.0
4020,0.2,True,0.012,64,True,difference,b,738,0,0,0,756,540,216,0.0
4020,0.2,True,0.012,64,False,baseline,b,2624,0,0,0,2688,2472,216,0.0
4020,0.2,True,0.012,64,False,vs_right,b,2624,20,13,7,2668,2465,203,0.65
4020,0.2,True,0.012,64,False,vs_left,b,2624,18,9,9,2670,2463,207,0.5
4020,0.2,True,0.012,64,False,difference,b,2624,0,0,0,2688,2472,216,0.0
4020,0.2,True,0.012,31,True,baseline,b,328,0,0,0,336,240,96,0.0
4020,0.2,True,0.012,31,True,vs_right,b,328,20,20,0,316,240,76,1.0
4020,0.2,True,0.012,31,True,vs_left,b,328,20,20,0,316,240,76,1.0
4020,0.2,True,0.012,31,True,difference,b,328,0,0,0,336,240,96,0.0
4020,0.2,True,0.012,31,False,baseline,b,1271,0,0,0,1302,1206,96,0.0
4020,0.2,True,0.012,31,False,vs_right,b,1271,17,12,5,1285,1201,84,0.7058823529411765
4020,0.2,True,0.012,31,False,vs_left,b,1271,18,13,5,1284,1201,83,0.7222222222222222
4020,0.2,True,0.012,31,False,difference,b,1271,0,0,0,1302,1206,96,0.0
4020,0.2,True,0.02,86,True,baseline,b,700,0,0,0,728,504,224,0.0
4020,0.2,True,0.02,86,True,vs_right,b,700,25,25,0,703,504,199,1.0
4020,0.2,True,0.02,86,True,vs_left,b,700,33,33,0,695,504,191,1.0
4020,0.2,True,0.02,86,True,difference,b,700,0,0,0,728,504,224,0.0
4020,0.2,True,0.02,86,False,baseline,b,2150,0,0,0,2236,2012,224,0.0
4020,0.2,True,0.02,86,False,vs_right,b,2150,23,15,8,2213,2004,209,0.6521739130434783
4020,0.2,True,0.02,86,False,vs_left,b,2150,23,16,7,2213,2005,208,0.6956521739130435
4020,0.2,True,0.02,86,False,difference,b,2150,0,0,0,2236,2012,224,0.0
4020,0.2,True,0.02,64,True,baseline,b,450,0,0,0,468,324,144,0.0
4020,0.2,True,0.02,64,True,vs_right,b,450,23,22,1,445,323,122,0.9565217391304348
4020,0.2,True,0.02,64,True,vs_left,b,450,25,25,0,443,324,119,1.0
4020,0.2,True,0.02,64,True,difference,b,450,0,0,0,468,324,144,0.0
4020,0.2,True,0.02,64,False,baseline,b,1600,0,0,0,1664,1520,144,0.0
4020,0.2,True,0.02,64,False,vs_right,b,1600,20,12,8,1644,1512,132,0.6
4020,0.2,True,0.02,64,False,vs_left,b,1600,23,17,6,1641,1514,127,0.7391304347826086
4020,0.2,True,0.02,64,False,difference,b,1600,0,0,0,1664,1520,144,0.0
4020,0.2,True,0.02,31,True,baseline,b,200,0,0,0,208,144,64,0.0
4020,0.2,True,0.02,31,True,vs_right,b,200,13,13,0,195,144,51,1.0
4020,0.2,True,0.02,31,True,vs_left,b,200,12,12,0,196,144,52,1.0
4020,0.2,True,0.02,31,True,difference,b,200,0,0,0,208,144,64,0.0
4020,0.2,True,0.02,31,False,baseline,b,775,0,0,0,806,742,64,0.0
4020,0.2,True,0.02,31,False,vs_right,b,775,16,9,7,790,735,55,0.5625
4020,0.2,True,0.02,31,False,vs_left,b,775,15,8,7,791,735,56,0.5333333333333333
4020,0.2,True,0.02,31,False,difference,b,775,0,0,0,806,742,64,0.0
4020,0.2,False,0.004,86,True,baseline,w,3500,4,0,4,3524,2460,1064,0.0
4020,0.2,False,0.004,86,True,vs_right,w,3500,455,417,38,3073,2426,647,0.9164835164835164
4020,0.2,False,0.004,86,True,vs_left,w,3500,460,447,13,3068,2451,617,0.9717391304347827
4020,0.2,False,0.004,86,True,difference,w,3500,12,4,8,3516,2456,1060,0.3333333333333333
4020,0.2,False,0.004,86,False,baseline,w,10750,17,0,17,10819,9755,1064,0.0
4020,0.2,False,0.004,86,False,vs_right,w,10750,852,379,473,9984,9299,685,0.4448356807511737
4020,0.2,False,0.004,86,False,vs_left,w,10750,831,405,426,10005,9346,659,0.48736462093862815
4020,0.2,False,0.004,86,False,difference,w,10750,28,2,26,10808,9746,1062,0.07142857142857142
4020,0.2,False,0.004,64,True,baseline,w,2250,4,0,4,2264,1580,684,0.0
4020,0.2,False,0.004,64,True,vs_right,w,2250,348,317,31,1920,1553,367,0.9109195402298851
4020,0.2,False,0.004,64,True,vs_left,w,2250,345,330,15,1923,1569,354,0.9565217391304348
4020,0.2,False,0.004,64,True,difference,w,2250,15,6,9,2253,1575,678,0.4
4020,0.2,False,0.004,64,False,baseline,w,8000,19,0,19,8045,7361,684,0.0
4020,0.2,False,0.004,64,False,vs_right,w,8000,665,286,379,7399,7001,398,0.43007518796992483
4020,0.2,False,0.004,64,False,vs_left,w,8000,642,290,352,7422,7028,394,0.4517133956386293
4020,0.2,False,0.004,64,False,difference,w,8000,26,0,26,8038,7354,684,0.0
4020,0.2,False,0.004,31,True,baseline,w,1000,6,2,4,1002,700,302,0.3333333333333333
4020,0.2,False,0.004,31,True,vs_right,w,1000,155,135,20,853,684,169,0.8709677419354839
4020,0.2,False,0.004,31,True,vs_left,w,1000,160,153,7,848,697,151,0.95625
4020,0.2,False,0.004,31,True,difference,w,1000,11,4,7,997,697,300,0.36363636363636365
4020,0.2,False,0.004,31,False,baseline,w,3875,9,0,9,3897,3593,304,0.0
4020,0.2,False,0.004,31,False,vs_right,w,3875,334,124,210,3572,3392,180,0.3712574850299401
4020,0.2,False,0.004,31,False,vs_left,w,3875,343,140,203,3563,3399,164,0.40816326530612246
4020,0.2,False,0.004,31,False,difference,w,3875,13,0,13,3893,3589,304,0.0
4020,0.2,False,0.012,86,True,baseline,w,1148,0,0,0,1176,840,336,0.0
4020,0.2,False,0.012,86,True,vs_right,w,1148,161,146,15,1015,825,190,0.906832298136646
4020,0.2,False,0.012,86,True,vs_left,w,1148,156,156,0,1020,840,180,1.0
4020,0.2,False,0.012,86,True,difference,w,1148,2,0,2,1174,838,336,0.0
4020,0.2,False,0.012,86,False,baseline,w,3526,2,0,2,3610,3274,336,0.0
4020,0.2,False,0.012,86,False,vs_right,w,3526,315,136,179,3297,3097,200,0.43174603174603177
4020,0.2,False,0.012,86,False,vs_left,w,3526,279,143,136,3333,3140,193,0.5125448028673835
4020,0.2,False,0.012,86,False,difference,w,3526,2,0,2,3610,3274,336,0.0
4020,0.2,False,0.012,64,True,baseline,w,738,2,0,2,754,538,216,0.0
4020,0.2,False,0.012,64,True,vs_right,w,738,123,108,15,633,525,108,0.8780487804878049
4020,0.2,False,0.012,64,True,vs_left,w,738,113,113,0,643,540,103,1.0
4020,0.2,False,0.012,64,True,difference,w,738,4,2,2,752,538,214,0.5
4020,0.2,False,0.012,64,False,baseline,w,2624,2,0,2,2686,2470,216,0.0
4020,0.2,False,0.012,64,False,vs_right,w,2624,245,103,142,2443,2330,113,0.4204081632653061
4020,0.2,False,0.012,64,False,vs_left,w,2624,224,106,118,2464,2354,110,0.4732142857142857
4020,0.2,False,0.012,64,False,difference,w,2624,2,0,2,2686,2470,216,0.0
4020,0.2,False,0.012,31,True,baseline,w,328,0,0,0,336,240,96,0.0
4020,0.2,False,0.012,31,True,vs_right,w,328,55,46,9,281,231,50,0.8363636363636363
4020,0.2,False,0.012,31,True,vs_left,w,328,57,54,3,279,237,42,0.9473684210526315
4020,0.2,False,0.012,31,True,difference,w,328,4,2,2,332,238,94,0.5
4020,0.2,False,0.012,31,False,baseline,w,1271,4,0,4,1298,1202,96,0.0
4020,0.2,False,0.012,31,False,vs_right,w,1271,113,43,70,1189,1136,53,0.3805309734513274
4020,0.2,False,0.012,31,False,vs_left,w,1271,117,48,69,1185,1137,48,0.41025641025641024
4020,0.2,False,0.012,31,False,difference,w,1271,2,0,2,1300,1204,96,0.0
4020,0.2,False,0.02,86,True,baseline,w,700,0,0,0,728,504,224,0.0
4020,0.2,False,0.02,86,True,vs_right,w,700,90,84,6,638,498,140,0.9333333333333333
4020,0.2,False,0.02,86,True,vs_left,w,700,84,84,0,644,504,140,1.0
4020,0.2,False,0.02,86,True,difference,w,700,0,0,0,728,504,224,0.0
4020,0.2,False,0.02,86,False,baseline,w,2150,0,0,0,2236,2012,224,0.0
4020,0.2,False,0.02,86,False,vs_right,w,2150,161,79,82,2075,1930,145,0.4906832298136646
4020,0.2,False,0.02,86,False,vs_left,w,2150,120,70,50,2116,1962,154,0.5833333333333334
4020,0.2,False,0.02,86,False,difference,w,2150,2,0,2,2234,2010,224,0.0
4020,0.2,False,0.02,64,True,baseline,w,450,0,0,0,468,324,144,0.0
4020,0.2,False,0.02,64,True,vs_right,w,450,69,64,5,399,319,80,0.927536231884058
4020,0.2,False,0.02,64,True,vs_left,w,450,60,60,0,408,324,84,1.0
4020,0.2,False,0.02,64,True,difference,w,450,2,2,0,466,324,142,1.0
4020,0.2,False,0.02,64,False,baseline,w,1600,0,0,0,1664,1520,144,0.0
4020,0.2,False,0.02,64,False,vs_right,w,1600,126,60,66,1538,1454,84,0.47619047619047616
4020,0.2,False,0.02,64,False,vs_left,w,1600,83,47,36,1581,1484,97,0.5662650602409639
4020,0.2,False,0.02,64,False,difference,w,1600,2,0,2,1662,1518,144,0.0
4020,0.2,False,0.02,31,True,baseline,w,200,0,0,0,208,144,64,0.0
4020,0.2,False,0.02,31,True,vs_right,w,200,33,28,5,175,139,36,0.8484848484848485
4020,0.2,False,0.02,31,True,vs_left,w,200,29,29,0,179,144,35,1.0
4020,0.2,False,0.02,31,True,difference,w,200,0,0,0,208,144,64,0.0
4020,0.2,False,0.02,31,False,baseline,w,775,0,0,0,806,742,64,0.0
4020,0.2,False,0.02,31,False,vs_right,w,775,59,24,35,747,707,40,0.4067796610169492
4020,0.2,False,0.02,31,False,vs_left,w,775,43,24,19,763,723,40,0.5581395348837209
4020,0.2,False,0.02,31,False,difference,w,775,1,0,1,805,741,64,0.0
4020,0.2,False,0.004,86,True,baseline,b,3500,0,0,0,3528,2464,1064,0.0
4020,0.2,False,0.004,86,True,vs_right,b,3500,50,50,0,3478,2464,1014,1.0
4020,0.2,False,0.004,86,True,vs_left,b,3500,45,45,0,3483,2464,1019,1.0
4020,0.2,False,0.004,86,True,difference,b,3500,0,0,0,3528,2464,1064,0.0
4020,0.2,False,0.004,86,False,baseline,b,10750,0,0,0,10836,9772,1064,0.0
4020,0.2,False,0.004,86,False,vs_right,b,10750,31,16,15,10805,9757,1048,0.5161290322580645
4020,0.2,False,0.004,86,False,vs_left,b,10750,8,6,2,10828,9770,1058,0.75
4020,0.2,False,0.004,86,False,difference,b,10750,0,0,0,10836,9772,1064,0.0
4020,0.2,False,0.004,64,True,baseline,b,2250,0,0,0,2268,1584,684,0.0
4020,0.2,False,0.004,64,True,vs_right,b,2250,45,45,0,2223,1584,639,1.0
4020,0.2,False,0.004,64,True,vs_left,b,2250,48,48,0,2220,1584,636,1.0
4020,0.2,False,0.004,64,True,difference,b,2250,0,0,0,2268,1584,684,0.0
4020,0.2,False,0.004,64,False,baseline,b,8000,0,0,0,8064,7380,684,0.0
4020,0.2,False,0.004,64,False,vs_right,b,8000,34,18,16,8030,7364,666,0.5294117647058824
4020,0.2,False,0.004,64,False,vs_left,b,8000,13,11,2,8051,7378,673,0.8461538461538461
4020,0.2,False,0.004,64,False,difference,b,8000,1,0,1,8063,7379,684,0.0
4020,0.2,False,0.004,31,True,baseline,b,1000,0,0,0,1008,704,304,0.0
4020,0.2,False,0.004,31,True,vs_right,b,1000,25,25,0,983,704,279,1.0
4020,0.2,False,0.004,31,True,vs_left,b,1000,47,47,0,961,704,257,1.0
4020,0.2,False,0.004,31,True,difference,b,1000,0,0,0,1008,704,304,0.0
4020,0.2,False,0.004,31,False,baseline,b,3875,0,0,0,3906,3602,304,0.0
4020,0.2,False,0.004,31,False,vs_right,b,3875,26,16,10,3880,3592,288,0.6153846153846154
4020,0.2,False,0.004,31,False,vs_left,b,3875,17,14,3,3889,3599,290,0.8235294117647058
4020,0.2,False,0.004,31,False,difference,b,3875,1,0,1,3905,3601,304,0.0
4020,0.2,False,0.012,86,True,baseline,b,1148,0,0,0,1176,840,336,0.0
4020,0.2,False,0.012,86,True,vs_right,b,1148,26,26,0,1150,840,310,1.0
4020,0.2,False,0.012,86,True,vs_left,b,1148,43,43,0,1133,840,293,1.0
4020,0.2,False,0.012,86,True,difference,b,1148,0,0,0,1176,840,336,0.0
4020,0.2,False,0.012,86,False,baseline,b,3526,0,0,0,3612,3276,336,0.0
4020,0.2,False,0.012,86,False,vs_right,b,3526,28,18,10,3584,3266,318,0.6428571428571429
4020,0.2,False,0.012,86,False,vs_left,b,3526,16,15,1,3596,3275,321,0.9375
4020,0.2,False,0.012,86,False,difference,b,3526,0,0,0,3612,3276,336,0.0
4020,0.2,False,0.012,64,True,baseline,b,738,0,0,0,756,540,216,0.0
4020,0.2,False,0.012,64,True,vs_right,b,738,27,27,0,729,540,189,1.0
4020,0.2,False,0.012,64,True,vs_left,b,738,36,36,0,720,540,180,1.0
4020,0.2,False,0.012,64,True,difference,b,738,0,0,0,756,540,216,0.0
4020,0.2,False,0.012,64,False,baseline,b,2624,0,0,0,2688,2472,216,0.0
4020,0.2,False,0.012,64,False,vs_right,b,2624,22,14,8,2666,2464,202,0.6363636363636364
4020,0.2,False,0.012,64,False,vs_left,b,2624,19,16,3,2669,2469,200,0.8421052631578947
4020,0.2,False,0.012,64,False,difference,b,2624,0,0,0,2688,2472,216,0.0
4020,0.2,False,0.012,31,True,baseline,b,328,0,0,0,336,240,96,0.0
4020,0.2,False,0.012,31,True,vs_right,b,328,18,18,0,318,240,78,1.0
4020,0.2,False,0.012,31,True,vs_left,b,328,21,21,0,315,240,75,1.0
4020,0.2,False,0.012,31,True,difference,b,328,0,0,0,336,240,96,0.0
4020,0.2,False,0.012,31,False,baseline,b,1271,0,0,0,1302,1206,96,0.0
4020,0.2,False,0.012,31,False,vs_right,b,1271,11,7,4,1291,1202,89,0.6363636363636364
4020,0.2,False,0.012,31,False,vs_left,b,1271,21,15,6,1281,1200,81,0.7142857142857143
4020,0.2,False,0.012,31,False,difference,b,1271,0,0,0,1302,1206,96,0.0
4020,0.2,False,0.02,86,True,baseline,b,700,0,0,0,728,504,224,0.0
4020,0.2,False,0.02,86,True,vs_right,b,700,19,19,0,709,504,205,1.0
4020,0.2,False,0.02,86,True,vs_left,b,700,30,30,0,698,504,194,1.0
4020,0.2,False,0.02,86,True,difference,b,700,0,0,0,728,504,224,0.0
4020,0.2,False,0.02,86,False,baseline,b,2150,0,0,0,2236,2012,224,0.0
4020,0.2,False,0.02,86,False,vs_right,b,2150,27,15,12,2209,2000,209,0.5555555555555556
4020,0.2,False,0.02,86,False,vs_left,b,2150,26,18,8,2210,2004,206,0.6923076923076923
4020,0.2,False,0.02,86,False,difference,b,2150,0,0,0,2236,2012,224,0.0
4020,0.2,False,0.02,64,True,baseline,b,450,0,0,0,468,324,144,0.0
4020,0.2,False,0.02,64,True,vs_right,b,450,16,16,0,452,324,128,1.0
4020,0.2,False,0.02,64,True,vs_left,b,450,28,28,0,440,324,116,1.0
4020,0.2,False,0.02,64,True,difference,b,450,0,0,0,468,324,144,0.0
4020,0.2,False,0.02,64,False,baseline,b,1600,0,0,0,1664,1520,144,0.0
4020,0.2,False,0.02,64,False,vs_right,b,1600,23,11,12,1641,1508,133,0.4782608695652174
4020,0.2,False,0.02,64,False,vs_left,b,1600,24,15,9,1640,1511,129,0.625
4020,0.2,False,0.02,64,False,difference,b,1600,0,0,0,1664,1520,144,0.0
4020,0.2,False,0.02,31,True,baseline,b,200,0,0,0,208,144,64,0.0
4020,0.2,False,0.02,31,True,vs_right,b,200,10,10,0,198,144,54,1.0
4020,0.2,False,0.02,31,True,vs_left,b,200,12,12,0,196,144,52,1.0
4020,0.2,False,0.02,31,True,difference,b,200,0,0,0,208,144,64,0.0
4020,0.2,False,0.02,31,False,baseline,b,775,0,0,0,806,742,64,0.0
4020,0.2,False,0.02,31,False,vs_right,b,775,10,5,5,796,737,59,0.5
4020,0.2,False,0.02,31,False,vs_left,b,775,17,11,6,789,736,53,0.6470588235294118
4020,0.2,False,0.02,31,False,difference,b,775,0,0,0,806,742,64,0.0
6030,0.1,True,0.004,86,True,baseline,w,3500,9,3,6,3519,2458,1061,0.3333333333333333
6030,0.1,True,0.004,86,True,vs_right,w,3500,434,401,33,3094,2431,663,0.923963133640553
6030,0.1,True,0.004,86,True,vs_left,w,3500,406,391,15,3122,2449,673,0.9630541871921182
6030,0.1,True,0.004,86,True,difference,w,3500,20,7,13,3508,2451,1057,0.35
6030,0.1,True,0.004,86,False,baseline,w,10750,19,2,17,10817,9755,1062,0.10526315789473684
6030,0.1,True,0.004,86,False,vs_right,w,10750,634,344,290,10202,9482,720,0.5425867507886435
6030,0.1,True,0.004,86,False,vs_left,w,10750,662,350,312,10174,9460,714,0.5287009063444109
6030,0.1,True,0.004,86,False,difference,w,10750,28,2,26,10808,9746,1062,0.07142857142857142
6030,0.1,True,0.004,64,True,baseline,w,2250,6,0,6,2262,1578,684,0.0
6030,0.1,True,0.004,64,True,vs_right,w,2250,323,290,33,1945,1551,394,0.8978328173374613
6030,0.1,True,0.004,64,True,vs_left,w,2250,306,293,13,1962,1571,391,0.9575163398692811
6030,0.1,True,0.004,64,True,difference,w,2250,12,6,6,2256,1578,678,0.5
6030,0.1,True,0.004,64,False,baseline,w,8000,16,0,16,8048,7364,684,0.0
6030,0.1,True,0.004,64,False,vs_right,w,8000,521,246,275,7543,7105,438,0.472168905950096
6030,0.1,True,0.004,64,False,vs_left,w,8000,510,262,248,7554,7132,422,0.5137254901960784
6030,0.1,True,0.004,64,False,difference,w,8000,27,2,25,8037,7355,682,0.07407407407407407
6030,0.1,True,0.004,31,True,baseline,w,1000,4,0,4,1004,700,304,0.0
6030,0.1,True,0.004,31,True,vs_right,w,1000,153,132,21,855,683,172,0.8627450980392157
6030,0.1,True,0.004,31,True,vs_left,w,1000,142,135,7,866,697,169,0.9507042253521126
6030,0.1,True,0.004,31,True,difference,w,1000,7,4,3,1001,701,300,0.5714285714285714
6030,0.1,True,0.004,31,False,baseline,w,3875,7,0,7,3899,3595,304,0.0
6030,0.1,True,0.004,31,False,vs_right,w,3875,284,121,163,3622,3439,183,0.426056338028169
6030,0.1,True,0.004,31,False,vs_left,w,3875,258,120,138,3648,3464,184,0.46511627906976744
6030,0.1,True,0.004,31,False,difference,w,3875,8,2,6,3898,3596,302,0.25
6030,0.1,True,0.012,86,True,baseline,w,1148,2,0,2,1174,838,336,0.0
6030,0.1,True,0.012,86,True,vs_right,w,1148,150,136,14,1026,826,200,0.9066666666666666
6030,0.1,True,0.012,86,True,vs_left,w,1148,139,137,2,1037,838,199,0.9856115107913669
6030,0.1,True,0.012,86,True,difference,w,1148,2,0,2,1174,838,336,0.0
6030,0.1,True,0.012,86,False,baseline,w,3526,2,0,2,3610,3274,336,0.0
6030,0.1,True,0.012,86,False,vs_right,w,3526,233,127,106,3379,3170,209,0.5450643776824035
6030,0.1,True,0.012,86,False,vs_left,w,3526,221,124,97,3391,3179,212,0.5610859728506787
6030,0.1,True,0.012,86,False,difference,w,3526,9,0,9,3603,3267,336,0.0
6030,0.1,True,0.012,64,True,baseline,w,738,2,0,2,754,538,216,0.0
6030,0.1,True,0.012,64,True,vs_right,w,738,112,100,12,644,528,116,0.8928571428571429
6030,0.1,True,0.012,64,True,vs_left,w,738,108,108,0,648,540,108,1.0
6030,0.1,True,0.012,64,True,difference,w,738,0,0,0,756,540,216,0.0
6030,0.1,True,0.012,64,False,baseline,w,2624,2,0,2,2686,2470,216,0.0
6030,0.1,True,0.012,64,False,vs_right,w,2624,188,93,95,2500,2377,123,0.4946808510638298
6030,0.1,True,0.012,64,False,vs_left,w,2624,171,93,78,2517,2394,123,0.543859649122807
6030,0.1,True,0.012,64,False,difference,w,2624,7,0,7,2681,2465,216,0.0
6030,0.1,True,0.012,31,True,baseline,w,328,2,0,2,334,238,96,0.0
6030,0.1,True,0.012,31,True,vs_right,w,328,53,44,9,283,231,52,0.8301886792452831
6030,0.1,True,0.012,31,True,vs_left,w,328,51,51,0,285,240,45,1.0
6030,0.1,True,0.012,31,True,difference,w,328,0,0,0,336,240,96,0.0
6030,0.1,True,0.012,31,False,baseline,w,1271,2,0,2,1300,1204,96,0.0
6030,0.1,True,0.012,31,False,vs_right,w,1271,96,42,54,1206,1152,54,0.4375
6030,0.1,True,0.012,31,False,vs_left,w,1271,83,44,39,1219,1167,52,0.5301204819277109
6030,0.1,True,0.012,31,False,difference,w,1271,0,0,0,1302,1206,96,0.0
6030,0.1,True,0.02,86,True,baseline,w,700,0,0,0,728,504,224,0.0
6030,0.1,True,0.02,86,True,vs_right,w,700,73,71,2,655,502,153,0.9726027397260274
6030,0.1,True,0.02,86,True,vs_left,w,700,73,71,2,655,502,153,0.9726027397260274
6030,0.1,True,0.02,86,True,difference,w,700,2,0,2,726,502,224,0.0
6030,0.1,True,0.02,86,False,baseline,w,2150,0,0,0,2236,2012,224,0.0
6030,0.1,True,0.02,86,False,vs_right,w,2150,104,63,41,2132,1971,161,0.6057692307692307
6030,0.1,True,0.02,86,False,vs_left,w,2150,78,52,26,2158,1986,172,0.6666666666666666
6030,0.1,True,0.02,86,False,difference,w,2150,3,0,3,2233,2009,224,0.0
6030,0.1,True,0.02,64,True,baseline,w,450,0,0,0,468,324,144,0.0
6030,0.1,True,0.02,64,True,vs_right,w,450,55,55,0,413,324,89,1.0
6030,0.1,True,0.02,64,True,vs_left,w,450,55,53,2,413,322,91,0.9636363636363636
6030,0.1,True,0.02,64,True,difference,w,450,0,0,0,468,324,144,0.0
6030,0.1,True,0.02,64,False,baseline,w,1600,0,0,0,1664,1520,144,0.0
6030,0.1,True,0.02,64,False,vs_right,w,1600,84,47,37,1580,1483,97,0.5595238095238095
6030,0.1,True,0.02,64,False,vs_left,w,1600,60,38,22,1604,1498,106,0.6333333333333333
6030,0.1,True,0.02,64,False,difference,w,1600,4,0,4,1660,1516,144,0.0
6030,0.1,True,0.02,31,True,baseline,w,200,0,0,0,208,144,64,0.0
6030,0.1,True,0.02,31,True,vs_right,w,200,23,23,0,185,144,41,1.0
6030,0.1,True,0.02,31,True,vs_left,w,200,32,29,3,176,141,35,0.90625
6030,0.1,True,0.02,31,True,difference,w,200,0,0,0,208,144,64,0.0
6030,0.1,True,0.02,31,False,baseline,w,775,0,0,0,806,742,64,0.0
6030,0.1,True,0.02,31,False,vs_right,w,775,45,23,22,761,720,41,0.5111111111111111
6030,0.1,True,0.02,31,False,vs_left,w,775,34,24,10,772,732,40,0.7058823529411765
6030,0.1,True,0.02,31,False,difference,w,775,0,0,0,806,742,64,0.0
6030,0.1,True,0.004,86,True,baseline,b,3500,0,0,0,3528,2464,1064,0.0
6030,0.1,True,0.004,86,True,vs_right,b,3500,45,45,0,3483,2464,1019,1.0
6030,0.1,True,0.004,86,True,vs_left,b,3500,17,17,0,3511,2464,1047,1.0
6030,0.1,True,0.004,86,True,difference,b,3500,0,0,0,3528,2464,1064,0.0
6030,0.1,True,0.004,86,False,baseline,b,10750,0,0,0,10836,9772,1064,0.0
6030,0.1,True,0.004,86,False,vs_right,b,10750,24,11,13,10812,9759,1053,0.4583333333333333
6030,0.1,True,0.004,86,False,vs_left,b,10750,7,2,5,10829,9767,1062,0.2857142857142857
6030,0.1,True,0.004,86,False,difference,b,10750,0,0,0,10836,9772,1064,0.0
6030,0.1,True,0.004,64,True,baseline,b,2250,0,0,0,2268,1584,684,0.0
6030,0.1,True,0.004,64,True,vs_right,b,2250,49,49,0,2219,1584,635,1.0
6030,0.1,True,0.004,64,True,vs_left,b,2250,29,29,0,2239,1584,655,1.0
6030,0.1,True,0.004,64,True,difference,b,2250,0,0,0,2268,1584,684,0.0
6030,0.1,True,0.004,64,False,baseline,b,8000,0,0,0,8064,7380,684,0.0
6030,0.1,True,0.004,64,False,vs_right,b,8000,31,17,14,8033,7366,667,0.5483870967741935
6030,0.1,True,0.004,64,False,vs_left,b,8000,9,2,7,8055,7373,682,0.2222222222222222
6030,0.1,True,0.004,64,False,difference,b,8000,0,0,0,8064,7380,684,0.0
6030,0.1,True,0.004,31,True,baseline,b,1000,0,0,0,1008,704,304,0.0
6030,0.1,True,0.004,31,True,vs_right,b,1000,28,28,0,980,704,276,1.0
6030,0.1,True,0.004,31,True,vs_left,b,1000,24,24,0,984,704,280,1.0
6030,0.1,True,0.004,31,True,difference,b,1000,0,0,0,1008,704,304,0.0
6030,0.1,True,0.004,31,False,baseline,b,3875,0,0,0,3906,3602,304,0.0
6030,0.1,True,0.004,31,False,vs_right,b,3875,24,6,18,3882,3584,298,0.25
6030,0.1,True,0.004,31,False,vs_left,b,3875,2,2,0,3904,3602,302,1.0
6030,0.1,True,0.004,31,False,difference,b,3875,0,0,0,3906,3602,304,0.0
6030,0.1,True,0.012,86,True,baseline,b,1148,0,0,0,1176,840,336,0.0
6030,0.1,True,0.012,86,True,vs_right,b,1148,27,27,0,1149,840,309,1.0
6030,0.1,True,0.012,86,True,vs_left,b,1148,24,24,0,1152,840,312,1.0
6030,0.1,True,0.012,86,True,difference,b,1148,0,0,0,1176,840,336,0.0
6030,0.1,True,0.012,86,False,baseline,b,3526,0,0,0,3612,3276,336,0.0
6030,0.1,True,0.012,86,False,vs_right,b,3526,19,13,6,3593,3270,323,0.6842105263157895
6030,0.1,True,0.012,86,False,vs_left,b,3526,10,5,5,3602,3271,331,0.5
6030,0.1,True,0.012,86,False,difference,b,3526,0,0,0,3612,3276,336,0.0
6030,0.1,True,0.012,64,True,baseline,b,738,0,0,0,756,540,216,0.0
6030,0.1,True,0.012,64,True,vs_right,b,738,26,26,0,730,540,190,1.0
6030,0.1,True,0.012,64,True,vs_left,b,738,24,24,0,732,540,192,1.0
6030,0.1,True,0.012,64,True,difference,b,738,0,0,0,756,540,216,0.0
6030,0.1,True,0.012,64,False,baseline,b,2624,0,0,0,2688,2472,216,0.0
6030,0.1,True,0.012,64,False,vs_right,b,2624,19,11,8,2669,2464,205,0.5789473684210527
6030,0.1,True,0.012,64,False,vs_left,b,2624,14,7,7,2674,2465,209,0.5
6030,0.1,True,0.012,64,False,difference,b,2624,0,0,0,2688,2472,216,0.0
6030,0.1,True,0.012,31,True,baseline,b,328,0,0,0,336,240,96,0.0
6030,0.1,True,0.012,31,True,vs_right,b,328,15,14,1,321,239,82,0.9333333333333333
6030,0.1,True,0.012,31,True,vs_left,b,328,16,16,0,320,240,80,1.0
6030,0.1,True,0.012,31,True,difference,b,328,0,0,0,336,240,96,0.0
6030,0.1,True,0.012,31,False,baseline,b,1271,0,0,0,1302,1206,96,0.0
6030,0.1,True,0.012,31,False,vs_right,b,1271,19,8,11,1283,1195,88,0.42105263157894735
6030,0.1,True,0.012,31,False,vs_left,b,1271,9,6,3,1293,1203,90,0.6666666666666666
6030,0.1,True,0.012,31,False,difference,b,1271,0,0,0,1302,1206,96,0.0
6030,0.1,True,0.02,86,True,baseline,b,700,0,0,0,728,504,224,0.0
6030,0.1,True,0.02,86,True,vs_right,b,700,20,20,0,708,504,204,1.0
6030,0.1,True,0.02,86,True,vs_left,b,700,27,27,0,701,504,197,1.0
6030,0.1,True,0.02,86,True,difference,b,700,0,0,0,728,504,224,0.0
6030,0.1,True,0.02,86,False,baseline,b,2150,0,0,0,2236,2012,224,0.0
6030,0.1,True,0.02,86,False,vs_right,b,2150,22,16,6,2214,2006,208,0.7272727272727273
6030,0.1,True,0.02,86,False,vs_left,b,2150,15,12,3,2221,2009,212,0.8
6030,0.1,True,0.02,86,False,difference,b,2150,0,0,0,2236,2012,224,0.0
6030,0.1,True,0.02,64,True,baseline,b,450,0,0,0,468,324,144,0.0
6030,0.1,True,0.02,64,True,vs_right,b,450,20,19,1,448,323,125,0.95
6030,0.1,True,0.02,64,True,vs_left,b,450,24,24,0,444,324,120,1.0
6030,0.1,True,0.02,64,True,difference,b,450,0,0,0,468,324,144,0.0
6030,0.1,True,0.02,64,False,baseline,b,1600,0,0,0,1664,1520,144,0.0
6030,0.1,True,0.02,64,False,vs_right,b,1600,19,13,6,1645,1514,131,0.6842105263157895
6030,0.1,True,0.02,64,False,vs_left,b,1600,17,12,5,1647,1515,132,0.7058823529411765
6030,0.1,True,0.02,64,False,difference,b,1600,0,0,0,1664,1520,144,0.0
6030,0.1,True,0.02,31,True,baseline,b,200,0,0,0,208,144,64,0.0
6030,0.1,True,0.02,31,True,vs_right,b,200,14,12,2,194,142,52,0.8571428571428571
6030,0.1,True,0.02,31,True,vs_left,b,200,12,12,0,196,144,52,1.0
6030,0.1,True,0.02,31,True,difference,b,200,0,0,0,208,144,64,0.0
6030,0.1,True,0.02,31,False,baseline,b,775,0,0,0,806,742,64,0.0
6030,0.1,True,0.02,31,False,vs_right,b,775,14,6,8,792,734,58,0.42857142857142855
6030,0.1,True,0.02,31,False,vs_left,b,775,11,9,2,795,740,55,0.8181818181818182
6030,0.1,True,0.02,31,False,difference,b,775,0,0,0,806,742,64,0.0
6030,0.1,False,0.004,86,True,baseline,w,3500,7,0,7,3521,2457,1064,0.0
6030,0.1,False,0.004,86,True,vs_right,w,3500,402,371,31,3126,2433,693,0.9228855721393034
6030,0.1,False,0.004,86,True,vs_left,w,3500,401,391,10,3127,2454,673,0.9750623441396509
6030,0.1,False,0.004,86,True,difference,w,3500,4,2,2,3524,2462,1062,0.5
6030,0.1,False,0.004,86,False,baseline,w,10750,10,0,10,10826,9762,1064,0.0
6030,0.1,False,0.004,86,False,vs_right,w,10750,568,332,236,10268,9536,732,0.5845070422535211
6030,0.1,False,0.004,86,False,vs_left,w,10750,585,344,241,10251,9531,720,0.588034188034188
6030,0.1,False,0.004,86,False,difference,w,10750,10,0,10,10826,9762,1064,0.0
6030,0.1,False,0.004,64,True,baseline,w,2250,0,0,0,2268,1584,684,0.0
6030,0.1,False,0.004,64,True,vs_right,w,2250,298,276,22,1970,1562,408,0.9261744966442953
6030,0.1,False,0.004,64,True,vs_left,w,2250,303,293,10,1965,1574,391,0.966996699669967
6030,0.1,False,0.004,64,True,difference,w,2250,2,0,2,2266,1582,684,0.0
6030,0.1,False,0.004,64,False,baseline,w,8000,10,0,10,8054,7370,684,0.0
6030,0.1,False,0.004,64,False,vs_right,w,8000,452,245,207,7612,7173,439,0.5420353982300885
6030,0.1,False,0.004,64,False,vs_left,w,8000,462,250,212,7602,7168,434,0.5411255411255411
6030,0.1,False,0.004,64,False,difference,w,8000,2,0,2,8062,7378,684,0.0
6030,0.1,False,0.004,31,True,baseline,w,1000,2,0,2,1006,702,304,0.0
6030,0.1,False,0.004,31,True,vs_right,w,1000,142,128,14,866,690,176,0.9014084507042254
6030,0.1,False,0.004,31,True,vs_left,w,1000,146,137,9,862,695,167,0.9383561643835616
6030,0.1,False,0.004,31,True,difference,w,1000,3,0,3,1005,701,304,0.0
6030,0.1,False,0.004,31,False,baseline,w,3875,5,0,5,3901,3597,304,0.0
6030,0.1,False,0.004,31,False,vs_right,w,3875,226,117,109,3680,3493,187,0.5176991150442478
6030,0.1,False,0.004,31,False,vs_left,w,3875,254,118,136,3652,3466,186,0.4645669291338583
6030,0.1,False,0.004,31,False,difference,w,3875,0,0,0,3906,3602,304,0.0
6030,0.1,False,0.012,86,True,baseline,w,1148,0,0,0,1176,840,336,0.0
6030,0.1,False,0.012,86,True,vs_right,w,1148,139,133,6,1037,834,203,0.9568345323741008
6030,0.1,False,0.012,86,True,vs_left,w,1148,153,149,4,1023,836,187,0.9738562091503268
6030,0.1,False,0.012,86,True,difference,w,1148,2,2,0,1174,840,334,1.0
6030,0.1,False,0.012,86,False,baseline,w,3526,0,0,0,3612,3276,336,0.0
6030,0.1,False,0.012,86,False,vs_right,w,3526,196,119,77,3416,3199,217,0.6071428571428571
6030,0.1,False,0.012,86,False,vs_left,w,3526,205,124,81,3407,3195,212,0.6048780487804878
6030,0.1,False,0.012,86,False,difference,w,3526,0,0,0,3612,3276,336,0.0
6030,0.1,False,0.012,64,True,baseline,w,738,0,0,0,756,540,216,0.0
6030,0.1,False,0.012,64,True,vs_right,w,738,103,95,8,653,532,121,0.9223300970873787
6030,0.1,False,0.012,64,True,vs_left,w,738,111,108,3,645,537,108,0.972972972972973
6030,0.1,False,0.012,64,True,difference,w,738,0,0,0,756,540,216,0.0
6030,0.1,False,0.012,64,False,baseline,w,2624,0,0,0,2688,2472,216,0.0
6030,0.1,False,0.012,64,False,vs_right,w,2624,148,89,59,2540,2413,127,0.6013513513513513
6030,0.1,False,0.012,64,False,vs_left,w,2624,166,92,74,2522,2398,124,0.5542168674698795
6030,0.1,False,0.012,64,False,difference,w,2624,0,0,0,2688,2472,216,0.0
6030,0.1,False,0.012,31,True,baseline,w,328,0,0,0,336,240,96,0.0
6030,0.1,False,0.012,31,True,vs_right,w,328,55,45,10,281,230,51,0.8181818181818182
6030,0.1,False,0.012,31,True,vs_left,w,328,50,47,3,286,237,49,0.94
6030,0.1,False,0.012,31,True,difference,w,328,0,0,0,336,240,96,0.0
6030,0.1,False,0.012,31,False,baseline,w,1271,0,0,0,1302,1206,96,0.0
6030,0.1,False,0.012,31,False,vs_right,w,1271,70,41,29,1232,1177,55,0.5857142857142857
6030,0.1,False,0.012,31,False,vs_left,w,1271,87,42,45,1215,1161,54,0.4827586206896552
6030,0.1,False,0.012,31,False,difference,w,1271,0,0,0,1302,1206,96,0.0
6030,0.1,False,0.02,86,True,baseline,w,700,0,0,0,728,504,224,0.0
6030,0.1,False,0.02,86,True,vs_right,w,700,80,73,7,648,497,151,0.9125
6030,0.1,False,0.02,86,True,vs_left,w,700,70,68,2,658,502,156,0.9714285714285714
6030,0.1,False,0.02,86,True,difference,w,700,0,0,0,728,504,224,0.0
6030,0.1,False,0.02,86,False,baseline,w,2150,0,0,0,2236,2012,224,0.0
6030,0.1,False,0.02,86,False,vs_right,w,2150,105,63,42,2131,1970,161,0.6
6030,0.1,False,0.02,86,False,vs_left,w,2150,82,56,26,2154,1986,168,0.6829268292682927
6030,0.1,False,0.02,86,False,difference,w,2150,0,0,0,2236,2012,224,0.0
6030,0.1,False,0.02,64,True,baseline,w,450,0,0,0,468,324,144,0.0
6030,0.1,False,0.02,64,True,vs_right,w,450,56,51,5,412,319,93,0.9107142857142857
6030,0.1,False,0.02,64,True,vs_left,w,450,55,53,2,413,322,91,0.9636363636363636
6030,0.1,False,0.02,64,True,difference,w,450,0,0,0,468,324,144,0.0
6030,0.1,False,0.02,64,False,baseline,w,1600,0,0,0,1664,1520,144,0.0
6030,0.1,False,0.02,64,False,vs_right,w,1600,74,47,27,1590,1493,97,0.6351351351351351
6030,0.1,False,0.02,64,False,vs_left,w,1600,63,38,25,1601,1495,106,0.6031746031746031
6030,0.1,False,0.02,64,False,difference,w,1600,0,0,0,1664,1520,144,0.0
6030,0.1,False,0.02,31,True,baseline,w,200,0,0,0,208,144,64,0.0
6030,0.1,False,0.02,31,True,vs_right,w,200,29,27,2,179,142,37,0.9310344827586207
6030,0.1,False,0.02,31,True,vs_left,w,200,29,27,2,179,142,37,0.9310344827586207
6030,0.1,False,0.02,31,True,difference,w,200,0,0,0,208,144,64,0.0
6030,0.1,False,0.02,31,False,baseline,w,775,0,0,0,806,742,64,0.0
6030,0.1,False,0.02,31,False,vs_right,w,775,38,23,15,768,727,41,0.6052631578947368
6030,0.1,False,0.02,31,False,vs_left,w,775,42,21,21,764,721,43,0.5
6030,0.1,False,0.02,31,False,difference,w,775,0,0,0,806,742,64,0.0
6030,0.1,False,0.004,86,True,baseline,b,3500,0,0,0,3528,2464,1064,0.0
6030,0.1,False,0.004,86,True,vs_right,b,3500,29,29,0,3499,2464,1035,1.0
6030,0.1,False,0.004,86,True,vs_left,b,3500,36,36,0,3492,2464,1028,1.0
6030,0.1,False,0.004,86,True,difference,b,3500,0,0,0,3528,2464,1064,0.0
6030,0.1,False,0.004,86,False,baseline,b,10750,0,0,0,10836,9772,1064,0.0
6030,0.1,False,0.004,86,False,vs_right,b,10750,11,4,7,10825,9765,1060,0.36363636363636365
6030,0.1,False,0.004,86,False,vs_left,b,10750,18,14,4,10818,9768,1050,0.7777777777777778
6030,0.1,False,0.004,86,False,difference,b,10750,1,0,1,10835,9771,1064,0.0
6030,0.1,False,0.004,64,True,baseline,b,2250,0,0,0,2268,1584,684,0.0
6030,0.1,False,0.004,64,True,vs_right,b,2250,25,25,0,2243,1584,659,1.0
6030,0.1,False,0.004,64,True,vs_left,b,2250,46,46,0,2222,1584,638,1.0
6030,0.1,False,0.004,64,True,difference,b,2250,0,0,0,2268,1584,684,0.0
6030,0.1,False,0.004,64,False,baseline,b,8000,0,0,0,8064,7380,684,0.0
6030,0.1,False,0.004,64,False,vs_right,b,8000,13,7,6,8051,7374,677,0.5384615384615384
6030,0.1,False,0.004,64,False,vs_left,b,8000,24,19,5,8040,7375,665,0.7916666666666666
6030,0.1,False,0.004,64,False,difference,b,8000,0,0,0,8064,7380,684,0.0
6030,0.1,False,0.004,31,True,baseline,b,1000,0,0,0,1008,704,304,0.0
6030,0.1,False,0.004,31,True,vs_right,b,1000,21,21,0,987,704,283,1.0
6030,0.1,False,0.004,31,True,vs_left,b,1000,31,31,0,977,704,273,1.0
6030,0.1,False,0.004,31,True,difference,b,1000,0,0,0,1008,704,304,0.0
6030,0.1,False,0.004,31,False,baseline,b,3875,0,0,0,3906,3602,304,0.0
6030,0.1,False,0.004,31,False,vs_right,b,3875,8,7,1,3898,3601,297,0.875
6030,0.1,False,0.004,31,False,vs_left,b,3875,18,11,7,3888,3595,293,0.6111111111111112
6030,0.1,False,0.004,31,False,difference,b,3875,0,0,0,3906,3602,304,0.0
6030,0.1,False,0.012,86,True,baseline,b,1148,0,0,0,1176,840,336,0.0
6030,0.1,False,0.012,86,True,vs_right,b,1148,23,23,0,1153,840,313,1.0
6030,0.1,False,0.012,86,True,vs_left,b,1148,34,34,0,1142,840,302,1.0
6030,0.1,False,0.012,86,True,difference,b,1148,0,0,0,1176,840,336,0.0
6030,0.1,False,0.012,86,False,baseline,b,3526,0,0,0,3612,3276,336,0.0
6030,0.1,False,0.012,86,False,vs_right,b,3526,14,8,6,3598,3270,328,0.5714285714285714
6030,0.1,False,0.012,86,False,vs_left,b,3526,11,9,2,3601,3274,327,0.8181818181818182
6030,0.1,False,0.012,86,False,difference,b,3526,0,0,0,3612,3276,336,0.0
6030,0.1,False,0.012,64,True,baseline,b,738,0,0,0,756,540,216,0.0
6030,0.1,False,0.012,64,True,vs_right,b,738,18,18,0,738,540,198,1.0
6030,0.1,False,0.012,64,True,vs_left,b,738,31,31,0,725,540,185,1.0
6030,0.1,False,0.012,64,True,difference,b,738,0,0,0,756,540,216,0.0
6030,0.1,False,0.012,64,False,baseline,b,2624,0,0,0,2688,2472,216,0.0
6030,0.1,False,0.012,64,False,vs_right,b,2624,9,5,4,2679,2468,211,0.5555555555555556
6030,0.1,False,0.012,64,False,vs_left,b,2624,12,10,2,2676,2470,206,0.8333333333333334
6030,0.1,False,0.012,64,False,difference,b,2624,0,0,0,2688,2472,216,0.0
6030,0.1,False,0.012,31,True,baseline,b,328,0,0,0,336,240,96,0.0
6030,0.1,False,0.012,31,True,vs_right,b,328,13,13,0,323,240,83,1.0
6030,0.1,False,0.012,31,True,vs_left,b,328,16,16,0,320,240,80,1.0
6030,0.1,False,0.012,31,True,difference,b,328,0,0,0,336,240,96,0.0
6030,0.1,False,0.012,31,False,baseline,b,1271,0,0,0,1302,1206,96,0.0
6030,0.1,False,0.012,31,False,vs_right,b,1271,7,6,1,1295,1205,90,0.8571428571428571
6030,0.1,False,0.012,31,False,vs_left,b,1271,13,9,4,1289,1202,87,0.6923076923076923
6030,0.1,False,0.012,31,False,difference,b,1271,0,0,0,1302,1206,96,0.0
6030,0.1,False,0.02,86,True,baseline,b,700,0,0,0,728,504,224,0.0
6030,0.1,False,0.02,86,True,vs_right,b,700,20,20,0,708,504,204,1.0
6030,0.1,False,0.02,86,True,vs_left,b,700,30,30,0,698,504,194,1.0
6030,0.1,False,0.02,86,True,difference,b,700,0,0,0,728,504,224,0.0
6030,0.1,False,0.02,86,False,baseline,b,2150,0,0,0,2236,2012,224,0.0
6030,0.1,False,0.02,86,False,vs_right,b,2150,17,11,6,2219,2006,213,0.6470588235294118
6030,0.1,False,0.02,86,False,vs_left,b,2150,20,15,5,2216,2007,209,0.75
6030,0.1,False,0.02,86,False,difference,b,2150,1,0,1,2235,2011,224,0.0
6030,0.1,False,0.02,64,True,baseline,b,450,0,0,0,468,324,144,0.0
6030,0.1,False,0.02,64,True,vs_right,b,450,16,16,0,452,324,128,1.0
6030,0.1,False,0.02,64,True,vs_left,b,450,27,27,0,441,324,117,1.0
6030,0.1,False,0.02,64,True,difference,b,450,0,0,0,468,324,144,0.0
6030,0.1,False,0.02,64,False,baseline,b,1600,0,0,0,1664,1520,144,0.0
6030,0.1,False,0.02,64,False,vs_right,b,1600,11,8,3,1653,1517,136,0.7272727272727273
6030,0.1,False,0.02,64,False,vs_left,b,1600,21,15,6,1643,1514,129,0.7142857142857143
6030,0.1,False,0.02,64,False,difference,b,1600,0,0,0,1664,1520,144,0.0
6030,0.1,False,0.02,31,True,baseline,b,200,0,0,0,208,144,64,0.0
6030,0.1,False,0.02,31,True,vs_right,b,200,10,9,1,198,143,55,0.9
6030,0.1,False,0.02,31,True,vs_left,b,200,11,11,0,197,144,53,1.0
6030,0.1,False,0.02,31,True,difference,b,200,0,0,0,208,144,64,0.0
6030,0.1,False,0.02,31,False,baseline,b,775,0,0,0,806,742,64,0.0
6030,0.1,False,0.02,31,False,vs_right,b,775,6,5,1,800,741,59,0.8333333333333334
6030,0.1,False,0.02,31,False,vs_left,b,775,13,9,4,793,738,55,0.6923076923076923
6030,0.1,False,0.02,31,False,difference,b,775,0,0,0,806,742,64,0.0
6030,0.2,True,0.004,86,True,baseline,w,3500,8,5,3,3520,2461,1059,0.625
6030,0.2,True,0.004,86,True,vs_right,w,3500,521,490,31,3007,2433,574,0.9404990403071017
6030,0.2,True,0.004,86,True,vs_left,w,3500,487,473,14,3041,2450,591,0.971252566735113
6030,0.2,True,0.004,86,True,difference,w,3500,16,16,0,3512,2464,1048,1.0
6030,0.2,True,0.004,86,False,baseline,w,10750,25,2,23,10811,9749,1062,0.08
6030,0.2,True,0.004,86,False,vs_right,w,10750,1175,450,725,9661,9047,614,0.3829787234042553
6030,0.2,True,0.004,86,False,vs_left,w,10750,1157,431,726,9679,9046,633,0.37251512532411407
6030,0.2,True,0.004,86,False,difference,w,10750,31,13,18,10805,9754,1051,0.41935483870967744
6030,0.2,True,0.004,64,True,baseline,w,2250,3,3,0,2265,1584,681,1.0
6030,0.2,True,0.004,64,True,vs_right,w,2250,378,353,25,1890,1559,331,0.9338624338624338
6030,0.2,True,0.004,64,True,vs_left,w,2250,347,338,9,1921,1575,346,0.9740634005763689
6030,0.2,True,0.004,64,True,difference,w,2250,10,8,2,2258,1582,676,0.8
6030,0.2,True,0.004,64,False,baseline,w,8000,18,2,16,8046,7364,682,0.1111111111111111
6030,0.2,True,0.004,64,False,vs_right,w,8000,901,322,579,7163,6801,362,0.35738068812430634
6030,0.2,True,0.004,64,False,vs_left,w,8000,893,304,589,7171,6791,380,0.3404255319148936
6030,0.2,True,0.004,64,False,difference,w,8000,17,3,14,8047,7366,681,0.17647058823529413
6030,0.2,True,0.004,31,True,baseline,w,1000,6,4,2,1002,702,300,0.6666666666666666
6030,0.2,True,0.004,31,True,vs_right,w,1000,180,153,27,828,677,151,0.85
6030,0.2,True,0.004,31,True,vs_left,w,1000,158,149,9,850,695,155,0.9430379746835443
6030,0.2,True,0.004,31,True,difference,w,1000,8,4,4,1000,700,300,0.5
6030,0.2,True,0.004,31,False,baseline,w,3875,14,3,11,3892,3591,301,0.21428571428571427
6030,0.2,True,0.004,31,False,vs_right,w,3875,456,141,315,3450,3287,163,0.3092105263157895
6030,0.2,True,0.004,31,False,vs_left,w,3875,445,138,307,3461,3295,166,0.3101123595505618
6030,0.2,True,0.004,31,False,difference,w,3875,16,4,12,3890,3590,300,0.25
6030,0.2,True,0.012,86,True,baseline,w,1148,0,0,0,1176,840,336,0.0
6030,0.2,True,0.012,86,True,vs_right,w,1148,179,169,10,997,830,167,0.9441340782122905
6030,0.2,True,0.012,86,True,vs_left,w,1148,172,169,3,1004,837,167,0.9825581395348837
6030,0.2,True,0.012,86,True,difference,w,1148,6,6,0,1170,840,330,1.0
6030,0.2,True,0.012,86,False,baseline,w,3526,2,0,2,3610,3274,336,0.0
6030,0.2,True,0.012,86,False,vs_right,w,3526,429,161,268,3183,3008,175,0.3752913752913753
6030,0.2,True,0.012,86,False,vs_left,w,3526,405,150,255,3207,3021,186,0.37037037037037035
6030,0.2,True,0.012,86,False,difference,w,3526,8,4,4,3604,3272,332,0.5
6030,0.2,True,0.012,64,True,baseline,w,738,0,0,0,756,540,216,0.0
6030,0.2,True,0.012,64,True,vs_right,w,738,131,120,11,625,529,96,0.916030534351145
6030,0.2,True,0.012,64,True,vs_left,w,738,121,121,0,635,540,95,1.0
6030,0.2,True,0.012,64,True,difference,w,738,2,2,0,754,540,214,1.0
6030,0.2,True,0.012,64,False,baseline,w,2624,2,0,2,2686,2470,216,0.0
6030,0.2,True,0.012,64,False,vs_right,w,2624,333,117,216,2355,2256,99,0.35135135135135137
6030,0.2,True,0.012,64,False,vs_left,w,2624,318,107,211,2370,2261,109,0.33647798742138363
6030,0.2,True,0.012,64,False,difference,w,2624,4,2,2,2684,2470,214,0.5
6030,0.2,True,0.012,31,True,baseline,w,328,0,0,0,336,240,96,0.0
6030,0.2,True,0.012,31,True,vs_right,w,328,61,50,11,275,229,46,0.819672131147541
6030,0.2,True,0.012,31,True,vs_left,w,328,55,55,0,281,240,41,1.0
6030,0.2,True,0.012,31,True,difference,w,328,2,2,0,334,240,94,1.0
6030,0.2,True,0.012,31,False,baseline,w,1271,0,0,0,1302,1206,96,0.0
6030,0.2,True,0.012,31,False,vs_right,w,1271,166,48,118,1136,1088,48,0.2891566265060241
6030,0.2,True,0.012,31,False,vs_left,w,1271,154,49,105,1148,1101,47,0.3181818181818182
6030,0.2,True,0.012,31,False,difference,w,1271,6,2,4,1296,1202,94,0.3333333333333333
6030,0.2,True,0.02,86,True,baseline,w,700,0,0,0,728,504,224,0.0
6030,0.2,True,0.02,86,True,vs_right,w,700,104,98,6,624,498,126,0.9423076923076923
6030,0.2,True,0.02,86,True,vs_left,w,700,96,96,0,632,504,128,1.0
6030,0.2,True,0.02,86,True,difference,w,700,4,4,0,724,504,220,1.0
6030,0.2,True,0.02,86,False,baseline,w,2150,0,0,0,2236,2012,224,0.0
6030,0.2,True,0.02,86,False,vs_right,w,2150,221,95,126,2015,1886,129,0.4298642533936652
6030,0.2,True,0.02,86,False,vs_left,w,2150,183,84,99,2053,1913,140,0.45901639344262296
6030,0.2,True,0.02,86,False,difference,w,2150,0,0,0,2236,2012,224,0.0
6030,0.2,True,0.02,64,True,baseline,w,450,0,0,0,468,324,144,0.0
6030,0.2,True,0.02,64,True,vs_right,w,450,76,70,6,392,318,74,0.9210526315789473
6030,0.2,True,0.02,64,True,vs_left,w,450,72,72,0,396,324,72,1.0
6030,0.2,True,0.02,64,True,difference,w,450,0,0,0,468,324,144,0.0
6030,0.2,True,0.02,64,False,baseline,w,1600,0,0,0,1664,1520,144,0.0
6030,0.2,True,0.02,64,False,vs_right,w,1600,170,68,102,1494,1418,76,0.4
6030,0.2,True,0.02,64,False,vs_left,w,1600,142,59,83,1522,1437,85,0.4154929577464789
6030,0.2,True,0.02,64,False,difference,w,1600,0,0,0,1664,1520,144,0.0
6030,0.2,True,0.02,31,True,baseline,w,200,0,0,0,208,144,64,0.0
6030,0.2,True,0.02,31,True,vs_right,w,200,38,32,6,170,138,32,0.8421052631578947
6030,0.2,True,0.02,31,True,vs_left,w,200,31,31,0,177,144,33,1.0
6030,0.2,True,0.02,31,True,difference,w,200,2,2,0,206,144,62,1.0
6030,0.2,True,0.02,31,False,baseline,w,775,0,0,0,806,742,64,0.0
6030,0.2,True,0.02,31,False,vs_right,w,775,79,27,52,727,690,37,0.34177215189873417
6030,0.2,True,0.02,31,False,vs_left,w,775,74,28,46,732,696,36,0.3783783783783784
6030,0.2,True,0.02,31,False,difference,w,775,0,0,0,806,742,64,0.0
6030,0.2,True,0.004,86,True,baseline,b,3500,0,0,0,3528,2464,1064,0.0
6030,0.2,True,0.004,86,True,vs_right,b,3500,57,57,0,3471,2464,1007,1.0
6030,0.2,True,0.004,86,True,vs_left,b,3500,53,53,0,3475,2464,1011,1.0
6030,0.2,True,0.004,86,True,difference,b,3500,0,0,0,3528,2464,1064,0.0
6030,0.2,True,0.004,86,False,baseline,b,10750,0,0,0,10836,9772,1064,0.0
6030,0.2,True,0.004,86,False,vs_right,b,10750,30,13,17,10806,9755,1051,0.43333333333333335
6030,0.2,True,0.004,86,False,vs_left,b,10750,31,3,28,10805,9744,1061,0.0967741935483871
6030,0.2,True,0.004,86,False,difference,b,10750,0,0,0,10836,9772,1064,0.0
6030,0.2,True,0.004,64,True,baseline,b,2250,0,0,0,2268,1584,684,0.0
6030,0.2,True,0.004,64,True,vs_right,b,2250,61,61,0,2207,1584,623,1.0
6030,0.2,True,0.004,64,True,vs_left,b,2250,55,55,0,2213,1584,629,1.0
6030,0.2,True,0.004,64,True,difference,b,2250,0,0,0,2268,1584,684,0.0
6030,0.2,True,0.004,64,False,baseline,b,8000,0,0,0,8064,7380,684,0.0
6030,0.2,True,0.004,64,False,vs_right,b,8000,30,17,13,8034,7367,667,0.5666666666666667
6030,0.2,True,0.004,64,False,vs_left,b,8000,27,3,24,8037,7356,681,0.1111111111111111
6030,0.2,True,0.004,64,False,difference,b,8000,0,0,0,8064,7380,684,0.0
6030,0.2,True,0.004,31,True,baseline,b,1000,0,0,0,1008,704,304,0.0
6030,0.2,True,0.004,31,True,vs_right,b,1000,37,37,0,971,704,267,1.0
6030,0.2,True,0.004,31,True,vs_left,b,1000,45,45,0,963,704,259,1.0
6030,0.2,True,0.004,31,True,difference,b,1000,0,0,0,1008,704,304,0.0
6030,0.2,True,0.004,31,False,baseline,b,3875,0,0,0,3906,3602,304,0.0
6030,0.2,True,0.004,31,False,vs_right,b,3875,26,16,10,3880,3592,288,0.6153846153846154
6030,0.2,True,0.004,31,False,vs_left,b,3875,37,12,25,3869,3577,292,0.32432432432432434
6030,0.2,True,0.004,31,False,difference,b,3875,0,0,0,3906,3602,304,0.0
6030,0.2,True,0.012,86,True,baseline,b,1148,0,0,0,1176,840,336,0.0
6030,0.2,True,0.012,86,True,vs_right,b,1148,34,34,0,1142,840,302,1.0
6030,0.2,True,0.012,86,True,vs_left,b,1148,52,52,0,1124,840,284,1.0
6030,0.2,True,0.012,86,True,difference,b,1148,1,1,0,1175,840,335,1.0
6030,0.2,True,0.012,86,False,baseline,b,3526,0,0,0,3612,3276,336,0.0
6030,0.2,True,0.012,86,False,vs_right,b,3526,35,20,15,3577,3261,316,0.5714285714285714
6030,0.2,True,0.012,86,False,vs_left,b,3526,36,14,22,3576,3254,322,0.3888888888888889
6030,0.2,True,0.012,86,False,difference,b,3526,0,0,0,3612,3276,336,0.0
6030,0.2,True,0.012,64,True,baseline,b,738,0,0,0,756,540,216,0.0
6030,0.2,True,0.012,64,True,vs_right,b,738,33,33,0,723,540,183,1.0
6030,0.2,True,0.012,64,True,vs_left,b,738,46,46,0,710,540,170,1.0
6030,0.2,True,0.012,64,True,difference,b,738,0,0,0,756,540,216,0.0
6030,0.2,True,0.012,64,False,baseline,b,2624,0,0,0,2688,2472,216,0.0
6030,0.2,True,0.012,64,False,vs_right,b,2624,31,16,15,2657,2457,200,0.5161290322580645
6030,0.2,True,0.012,64,False,vs_left,b,2624,31,11,20,2657,2452,205,0.3548387096774194
6030,0.2,True,0.012,64,False,difference,b,2624,0,0,0,2688,2472,216,0.0
6030,0.2,True,0.012,31,True,baseline,b,328,0,0,0,336,240,96,0.0
6030,0.2,True,0.012,31,True,vs_right,b,328,20,20,0,316,240,76,1.0
6030,0.2,True,0.012,31,True,vs_left,b,328,25,25,0,311,240,71,1.0
6030,0.2,True,0.012,31,True,difference,b,328,0,0,0,336,240,96,0.0
6030,0.2,True,0.012,31,False,baseline,b,1271,0,0,0,1302,1206,96,0.0
6030,0.2,True,0.012,31,False,vs_right,b,1271,22,10,12,1280,1194,86,0.45454545454545453
6030,0.2,True,0.012,31,False,vs_left,b,1271,33,15,18,1269,1188,81,0.45454545454545453
6030,0.2,True,0.012,31,False,difference,b,1271,0,0,0,1302,1206,96,0.0
6030,0.2,True,0.02,86,True,baseline,b,700,0,0,0,728,504,224,0.0
6030,0.2,True,0.02,86,True,vs_right,b,700,25,25,0,703,504,199,1.0
6030,0.2,True,0.02,86,True,vs_left,b,700,43,43,0,685,504,181,1.0
6030,0.2,True,0.02,86,True,difference,b,700,1,1,0,727,504,223,1.0
6030,0.2,True,0.02,86,False,baseline,b,2150,0,0,0,2236,2012,224,0.0
6030,0.2,True,0.02,86,False,vs_right,b,2150,43,21,22,2193,1990,203,0.4883720930232558
6030,0.2,True,0.02,86,False,vs_left,b,2150,46,29,17,2190,1995,195,0.6304347826086957
6030,0.2,True,0.02,86,False,difference,b,2150,0,0,0,2236,2012,224,0.0
6030,0.2,True,0.02,64,True,baseline,b,450,0,0,0,468,324,144,0.0
6030,0.2,True,0.02,64,True,vs_right,b,450,23,23,0,445,324,121,1.0
6030,0.2,True,0.02,64,True,vs_left,b,450,32,32,0,436,324,112,1.0
6030,0.2,True,0.02,64,True,difference,b,450,0,0,0,468,324,144,0.0
6030,0.2,True,0.02,64,False,baseline,b,1600,0,0,0,1664,1520,144,0.0
6030,0.2,True,0.02,64,False,vs_right,b,1600,32,15,17,1632,1503,129,0.46875
6030,0.2,True,0.02,64,False,vs_left,b,1600,44,25,19,1620,1501,119,0.5681818181818182
6030,0.2,True,0.02,64,False,difference,b,1600,0,0,0,1664,1520,144,0.0
6030,0.2,True,0.02,31,True,baseline,b,200,0,0,0,208,144,64,0.0
6030,0.2,True,0.02,31,True,vs_right,b,200,12,12,0,196,144,52,1.0
6030,0.2,True,0.02,31,True,vs_left,b,200,14,14,0,194,144,50,1.0
6030,0.2,True,0.02,31,True,difference,b,200,0,0,0,208,144,64,0.0
6030,0.2,True,0.02,31,False,baseline,b,775,0,0,0,806,742,64,0.0
6030,0.2,True,0.02,31,False,vs_right,b,775,21,7,14,785,728,57,0.3333333333333333
6030,0.2,True,0.02,31,False,vs_left,b,775,26,13,13,780,729,51,0.5
6030,0.2,True,0.02,31,False,difference,b,775,0,0,0,806,742,64,0.0
6030,0.2,False,0.004,86,True,baseline,w,3500,0,0,0,3528,2464,1064,0.0
6030,0.2,False,0.004,86,True,vs_right,w,3500,517,466,51,3011,2413,598,0.9013539651837524
6030,0.2,False,0.004,86,True,vs_left,w,3500,480,457,23,3048,2441,607,0.9520833333333333
6030,0.2,False,0.004,86,True,difference,w,3500,16,7,9,3512,2455,1057,0.4375
6030,0.2,False,0.004,86,False,baseline,w,10750,13,0,13,10823,9759,1064,0.0
6030,0.2,False,0.004,86,False,vs_right,w,10750,1084,419,665,9752,9107,645,0.3865313653136531
6030,0.2,False,0.004,86,False,vs_left,w,10750,1083,419,664,9753,9108,645,0.38688827331486614
6030,0.2,False,0.004,86,False,difference,w,10750,15,3,12,10821,9760,1061,0.2
6030,0.2,False,0.004,64,True,baseline,w,2250,0,0,0,2268,1584,684,0.0
6030,0.2,False,0.004,64,True,vs_right,w,2250,383,341,42,1885,1542,343,0.8903394255874674
6030,0.2,False,0.004,64,True,vs_left,w,2250,355,337,18,1913,1566,347,0.9492957746478873
6030,0.2,False,0.004,64,True,difference,w,2250,13,2,11,2255,1573,682,0.15384615384615385
6030,0.2,False,0.004,64,False,baseline,w,8000,10,0,10,8054,7370,684,0.0
6030,0.2,False,0.004,64,False,vs_right,w,8000,816,308,508,7248,6872,376,0.37745098039215685
6030,0.2,False,0.004,64,False,vs_left,w,8000,837,310,527,7227,6853,374,0.37037037037037035
6030,0.2,False,0.004,64,False,difference,w,8000,12,0,12,8052,7368,684,0.0
6030,0.2,False,0.004,31,True,baseline,w,1000,0,0,0,1008,704,304,0.0
6030,0.2,False,0.004,31,True,vs_right,w,1000,177,150,27,831,677,154,0.847457627118644
6030,0.2,False,0.004,31,True,vs_left,w,1000,164,148,16,844,688,156,0.9024390243902439
6030,0.2,False,0.004,31,True,difference,w,1000,16,3,13,992,691,301,0.1875
6030,0.2,False,0.004,31,False,baseline,w,3875,2,0,2,3904,3600,304,0.0
6030,0.2,False,0.004,31,False,vs_right,w,3875,433,140,293,3473,3309,164,0.3233256351039261
6030,0.2,False,0.004,31,False,vs_left,w,3875,418,134,284,3488,3318,170,0.32057416267942584
6030,0.2,False,0.004,31,False,difference,w,3875,10,0,10,3896,3592,304,0.0
6030,0.2,False,0.012,86,True,baseline,w,1148,0,0,0,1176,840,336,0.0
6030,0.2,False,0.012,86,True,vs_right,w,1148,182,162,20,994,820,174,0.8901098901098901
6030,0.2,False,0.012,86,True,vs_left,w,1148,167,165,2,1009,838,171,0.9880239520958084
6030,0.2,False,0.012,86,True,difference,w,1148,5,2,3,1171,837,334,0.4
6030,0.2,False,0.012,86,False,baseline,w,3526,0,0,0,3612,3276,336,0.0
6030,0.2,False,0.012,86,False,vs_right,w,3526,398,153,245,3214,3031,183,0.3844221105527638
6030,0.2,False,0.012,86,False,vs_left,w,3526,372,146,226,3240,3050,190,0.3924731182795699
6030,0.2,False,0.012,86,False,difference,w,3526,4,2,2,3608,3274,334,0.5
6030,0.2,False,0.012,64,True,baseline,w,738,0,0,0,756,540,216,0.0
6030,0.2,False,0.012,64,True,vs_right,w,738,131,117,14,625,526,99,0.8931297709923665
6030,0.2,False,0.012,64,True,vs_left,w,738,124,124,0,632,540,92,1.0
6030,0.2,False,0.012,64,True,difference,w,738,3,0,3,753,537,216,0.0
6030,0.2,False,0.012,64,False,baseline,w,2624,3,0,3,2685,2469,216,0.0
6030,0.2,False,0.012,64,False,vs_right,w,2624,302,111,191,2386,2281,105,0.3675496688741722
6030,0.2,False,0.012,64,False,vs_left,w,2624,279,105,174,2409,2298,111,0.3763440860215054
6030,0.2,False,0.012,64,False,difference,w,2624,3,0,3,2685,2469,216,0.0
6030,0.2,False,0.012,31,True,baseline,w,328,0,0,0,336,240,96,0.0
6030,0.2,False,0.012,31,True,vs_right,w,328,61,50,11,275,229,46,0.819672131147541
6030,0.2,False,0.012,31,True,vs_left,w,328,56,54,2,280,238,42,0.9642857142857143
6030,0.2,False,0.012,31,True,difference,w,328,3,0,3,333,237,96,0.0
6030,0.2,False,0.012,31,False,baseline,w,1271,0,0,0,1302,1206,96,0.0
6030,0.2,False,0.012,31,False,vs_right,w,1271,152,49,103,1150,1103,47,0.3223684210526316
6030,0.2,False,0.012,31,False,vs_left,w,1271,146,46,100,1156,1106,50,0.3150684931506849
6030,0.2,False,0.012,31,False,difference,w,1271,3,0,3,1299,1203,96,0.0
6030,0.2,False,0.02,86,True,baseline,w,700,0,0,0,728,504,224,0.0
6030,0.2,False,0.02,86,True,vs_right,w,700,106,94,12,622,492,130,0.8867924528301887
6030,0.2,False,0.02,86,True,vs_left,w,700,99,97,2,629,502,127,0.9797979797979798
6030,0.2,False,0.02,86,True,difference,w,700,0,0,0,728,504,224,0.0
6030,0.2,False,0.02,86,False,baseline,w,2150,2,0,2,2234,2010,224,0.0
6030,0.2,False,0.02,86,False,vs_right,w,2150,228,87,141,2008,1871,137,0.3815789473684211
6030,0.2,False,0.02,86,False,vs_left,w,2150,168,83,85,2068,1927,141,0.49404761904761907
6030,0.2,False,0.02,86,False,difference,w,2150,0,0,0,2236,2012,224,0.0
6030,0.2,False,0.02,64,True,baseline,w,450,0,0,0,468,324,144,0.0
6030,0.2,False,0.02,64,True,vs_right,w,450,76,68,8,392,316,76,0.8947368421052632
6030,0.2,False,0.02,64,True,vs_left,w,450,68,68,0,400,324,76,1.0
6030,0.2,False,0.02,64,True,difference,w,450,0,0,0,468,324,144,0.0
6030,0.2,False,0.02,64,False,baseline,w,1600,2,0,2,1662,1518,144,0.0
6030,0.2,False,0.02,64,False,vs_right,w,1600,167,61,106,1497,1414,83,0.3652694610778443
6030,0.2,False,0.02,64,False,vs_left,w,1600,132,60,72,1532,1448,84,0.45454545454545453
6030,0.2,False,0.02,64,False,difference,w,1600,0,0,0,1664,1520,144,0.0
6030,0.2,False,0.02,31,True,baseline,w,200,0,0,0,208,144,64,0.0
6030,0.2,False,0.02,31,True,vs_right,w,200,32,30,2,176,142,34,0.9375
6030,0.2,False,0.02,31,True,vs_left,w,200,30,30,0,178,144,34,1.0
6030,0.2,False,0.02,31,True,difference,w,200,2,0,2,206,142,64,0.0
6030,0.2,False,0.02,31,False,baseline,w,775,0,0,0,806,742,64,0.0
6030,0.2,False,0.02,31,False,vs_right,w,775,82,27,55,724,687,37,0.32926829268292684
6030,0.2,False,0.02,31,False,vs_left,w,775,76,28,48,730,694,36,0.3684210526315789
6030,0.2,False,0.02,31,False,difference,w,775,0,0,0,806,742,64,0.0
6030,0.2,False,0.004,86,True,baseline,b,3500,0,0,0,3528,2464,1064,0.0
6030,0.2,False,0.004,86,True,vs_right,b,3500,60,59,1,3468,2463,1005,0.9833333333333333
6030,0.2,False,0.004,86,True,vs_left,b,3500,47,47,0,3481,2464,1017,1.0
6030,0.2,False,0.004,86,True,difference,b,3500,0,0,0,3528,2464,1064,0.0
6030,0.2,False,0.004,86,False,baseline,b,10750,0,0,0,10836,9772,1064,0.0
6030,0.2,False,0.004,86,False,vs_right,b,10750,26,10,16,10810,9756,1054,0.38461538461538464
6030,0.2,False,0.004,86,False,vs_left,b,10750,32,3,29,10804,9743,1061,0.09375
6030,0.2,False,0.004,86,False,difference,b,10750,0,0,0,10836,9772,1064,0.0
6030,0.2,False,0.004,64,True,baseline,b,2250,0,0,0,2268,1584,684,0.0
6030,0.2,False,0.004,64,True,vs_right,b,2250,64,62,2,2204,1582,622,0.96875
6030,0.2,False,0.004,64,True,vs_left,b,2250,58,58,0,2210,1584,626,1.0
6030,0.2,False,0.004,64,True,difference,b,2250,0,0,0,2268,1584,684,0.0
6030,0.2,False,0.004,64,False,baseline,b,8000,0,0,0,8064,7380,684,0.0
6030,0.2,False,0.004,64,False,vs_right,b,8000,29,14,15,8035,7365,670,0.4827586206896552
6030,0.2,False,0.004,64,False,vs_left,b,8000,19,3,16,8045,7364,681,0.15789473684210525
6030,0.2,False,0.004,64,False,difference,b,8000,0,0,0,8064,7380,684,0.0
6030,0.2,False,0.004,31,True,baseline,b,1000,0,0,0,1008,704,304,0.0
6030,0.2,False,0.004,31,True,vs_right,b,1000,38,38,0,970,704,266,1.0
6030,0.2,False,0.004,31,True,vs_left,b,1000,43,41,2,965,702,263,0.9534883720930233
6030,0.2,False,0.004,31,True,difference,b,1000,0,0,0,1008,704,304,0.0
6030,0.2,False,0.004,31,False,baseline,b,3875,0,0,0,3906,3602,304,0.0
6030,0.2,False,0.004,31,False,vs_right,b,3875,30,19,11,3876,3591,285,0.6333333333333333
6030,0.2,False,0.004,31,False,vs_left,b,3875,30,13,17,3876,3585,291,0.43333333333333335
6030,0.2,False,0.004,31,False,difference,b,3875,0,0,0,3906,3602,304,0.0
6030,0.2,False,0.012,86,True,baseline,b,1148,1,0,1,1175,839,336,0.0
6030,0.2,False,0.012,86,True,vs_right,b,1148,36,36,0,1140,840,300,1.0
6030,0.2,False,0.012,86,True,vs_left,b,1148,46,45,1,1130,839,291,0.9782608695652174
6030,0.2,False,0.012,86,True,difference,b,1148,0,0,0,1176,840,336,0.0
6030,0.2,False,0.012,86,False,baseline,b,3526,0,0,0,3612,3276,336,0.0
6030,0.2,False,0.012,86,False,vs_right,b,3526,30,19,11,3582,3265,317,0.6333333333333333
6030,0.2,False,0.012,86,False,vs_left,b,3526,35,12,23,3577,3253,324,0.34285714285714286
6030,0.2,False,0.012,86,False,difference,b,3526,0,0,0,3612,3276,336,0.0
6030,0.2,False,0.012,64,True,baseline,b,738,0,0,0,756,540,216,0.0
6030,0.2,False,0.012,64,True,vs_right,b,738,33,33,0,723,540,183,1.0
6030,0.2,False,0.012,64,True,vs_left,b,738,45,44,1,711,539,172,0.9777777777777777
6030,0.2,False,0.012,64,True,difference,b,738,0,0,0,756,540,216,0.0
6030,0.2,False,0.012,64,False,baseline,b,2624,0,0,0,2688,2472,216,0.0
6030,0.2,False,0.012,64,False,vs_right,b,2624,29,17,12,2659,2460,199,0.5862068965517241
6030,0.2,False,0.012,64,False,vs_left,b,2624,27,12,15,2661,2457,204,0.4444444444444444
6030,0.2,False,0.012,64,False,difference,b,2624,0,0,0,2688,2472,216,0.0
6030,0.2,False,0.012,31,True,baseline,b,328,0,0,0,336,240,96,0.0
6030,0.2,False,0.012,31,True,vs_right,b,328,20,20,0,316,240,76,1.0
6030,0.2,False,0.012,31,True,vs_left,b,328,23,22,1,313,239,74,0.9565217391304348
6030,0.2,False,0.012,31,True,difference,b,328,0,0,0,336,240,96,0.0
6030,0.2,False,0.012,31,False,baseline,b,1271,0,0,0,1302,1206,96,0.0
6030,0.2,False,0.012,31,False,vs_right,b,1271,21,11,10,1281,1196,85,0.5238095238095238
6030,0.2,False,0.012,31,False,vs_left,b,1271,27,13,14,1275,1192,83,0.48148148148148145
6030,0.2,False,0.012,31,False,difference,b,1271,0,0,0,1302,1206,96,0.0
6030,0.2,False,0.02,86,True,baseline,b,700,0,0,0,728,504,224,0.0
6030,0.2,False,0.02,86,True,vs_right,b,700,23,23,0,705,504,201,1.0
6030,0.2,False,0.02,86,True,vs_left,b,700,39,39,0,689,504,185,1.0
6030,0.2,False,0.02,86,True,difference,b,700,0,0,0,728,504,224,0.0
6030,0.2,False,0.02,86,False,baseline,b,2150,0,0,0,2236,2012,224,0.0
6030,0.2,False,0.02,86,False,vs_right,b,2150,30,19,11,2206,2001,205,0.6333333333333333
6030,0.2,False,0.02,86,False,vs_left,b,2150,47,27,20,2189,1992,197,0.574468085106383
6030,0.2,False,0.02,86,False,difference,b,2150,1,0,1,2235,2011,224,0.0
6030,0.2,False,0.02,64,True,baseline,b,450,0,0,0,468,324,144,0.0
6030,0.2,False,0.02,64,True,vs_right,b,450,23,23,0,445,324,121,1.0
6030,0.2,False,0.02,64,True,vs_left,b,450,30,30,0,438,324,114,1.0
6030,0.2,False,0.02,64,True,difference,b,450,0,0,0,468,324,144,0.0
6030,0.2,False,0.02,64,False,baseline,b,1600,0,0,0,1664,1520,144,0.0
6030,0.2,False,0.02,64,False,vs_right,b,1600,25,16,9,1639,1511,128,0.64
6030,0.2,False,0.02,64,False,vs_left,b,1600,41,24,17,1623,1503,120,0.5853658536585366
6030,0.2,False,0.02,64,False,difference,b,1600,1,0,1,1663,1519,144,0.0
6030,0.2,False,0.02,31,True,baseline,b,200,0,0,0,208,144,64,0.0
6030,0.2,False,0.02,31,True,vs_right,b,200,12,12,0,196,144,52,1.0
6030,0.2,False,0.02,31,True,vs_left,b,200,14,14,0,194,144,50,1.0
6030,0.2,False,0.02,31,True,difference,b,200,0,0,0,208,144,64,0.0
6030,0.2,False,0.02,31,False,baseline,b,775,0,0,0,806,742,64,0.0
6030,0.2,False,0.02,31,False,vs_right,b,775,17,8,9,789,733,56,0.47058823529411764
6030,0.2,False,0.02,31,False,vs_left,b,775,24,12,12,782,730,52,0.5
6030,0.2,False,0.02,31,False,difference,b,775,0,0,0,806,742,64,0.0
6020,0.1,True,0.004,86,True,baseline,w,3500,16,0,16,3512,2448,1064,0.0
6020,0.1,True,0.004,86,True,vs_right,w,3500,395,344,51,3133,2413,720,0.8708860759493671
6020,0.1,True,0.004,86,True,vs_left,w,3500,413,401,12,3115,2452,663,0.9709443099273608
6020,0.1,True,0.004,86,True,difference,w,3500,31,10,21,3497,2443,1054,0.3225806451612903
6020,0.1,True,0.004,86,False,baseline,w,10750,23,0,23,10813,9749,1064,0.0
6020,0.1,True,0.004,86,False,vs_right,w,10750,630,300,330,10206,9442,764,0.47619047619047616
6020,0.1,True,0.004,86,False,vs_left,w,10750,597,345,252,10239,9520,719,0.5778894472361809
6020,0.1,True,0.004,86,False,difference,w,10750,38,8,30,10798,9742,1056,0.21052631578947367
6020,0.1,True,0.004,64,True,baseline,w,2250,16,0,16,2252,1568,684,0.0
6020,0.1,True,0.004,64,True,vs_right,w,2250,297,264,33,1971,1551,420,0.8888888888888888
6020,0.1,True,0.004,64,True,vs_left,w,2250,308,294,14,1960,1570,390,0.9545454545454546
6020,0.1,True,0.004,64,True,difference,w,2250,27,5,22,2241,1562,679,0.18518518518518517
6020,0.1,True,0.004,64,False,baseline,w,8000,24,0,24,8040,7356,684,0.0
6020,0.1,True,0.004,64,False,vs_right,w,8000,497,229,268,7567,7112,455,0.4607645875251509
6020,0.1,True,0.004,64,False,vs_left,w,8000,472,251,221,7592,7159,433,0.5317796610169492
6020,0.1,True,0.004,64,False,difference,w,8000,34,3,31,8030,7349,681,0.08823529411764706
6020,0.1,True,0.004,31,True,baseline,w,1000,13,0,13,995,691,304,0.0
6020,0.1,True,0.004,31,True,vs_right,w,1000,130,117,13,878,691,187,0.9
6020,0.1,True,0.004,31,True,vs_left,w,1000,141,129,12,867,692,175,0.9148936170212766
6020,0.1,True,0.004,31,True,difference,w,1000,8,2,6,1000,698,302,0.25
6020,0.1,True,0.004,31,False,baseline,w,3875,15,0,15,3891,3587,304,0.0
6020,0.1,True,0.004,31,False,vs_right,w,3875,276,105,171,3630,3431,199,0.3804347826086957
6020,0.1,True,0.004,31,False,vs_left,w,3875,261,115,146,3645,3456,189,0.44061302681992337
6020,0.1,True,0.004,31,False,difference,w,3875,15,0,15,3891,3587,304,0.0
6020,0.1,True,0.012,86,True,baseline,w,1148,4,0,4,1172,836,336,0.0
6020,0.1,True,0.012,86,True,vs_right,w,1148,135,122,13,1041,827,214,0.9037037037037037
6020,0.1,True,0.012,86,True,vs_left,w,1148,148,146,2,1028,838,190,0.9864864864864865
6020,0.1,True,0.012,86,True,difference,w,1148,3,0,3,1173,837,336,0.0
6020,0.1,True,0.012,86,False,baseline,w,3526,3,0,3,3609,3273,336,0.0
6020,0.1,True,0.012,86,False,vs_right,w,3526,229,115,114,3383,3162,221,0.5021834061135371
6020,0.1,True,0.012,86,False,vs_left,w,3526,222,134,88,3390,3188,202,0.6036036036036037
6020,0.1,True,0.012,86,False,difference,w,3526,5,0,5,3607,3271,336,0.0
6020,0.1,True,0.012,64,True,baseline,w,738,6,0,6,750,534,216,0.0
6020,0.1,True,0.012,64,True,vs_right,w,738,99,93,6,657,534,123,0.9393939393939394
6020,0.1,True,0.012,64,True,vs_left,w,738,111,109,2,645,538,107,0.9819819819819819
6020,0.1,True,0.012,64,True,difference,w,738,5,2,3,751,537,214,0.4
6020,0.1,True,0.012,64,False,baseline,w,2624,3,0,3,2685,2469,216,0.0
6020,0.1,True,0.012,64,False,vs_right,w,2624,174,84,90,2514,2382,132,0.4827586206896552
6020,0.1,True,0.012,64,False,vs_left,w,2624,171,96,75,2517,2397,120,0.5614035087719298
6020,0.1,True,0.012,64,False,difference,w,2624,7,0,7,2681,2465,216,0.0
6020,0.1,True,0.012,31,True,baseline,w,328,4,0,4,332,236,96,0.0
6020,0.1,True,0.012,31,True,vs_right,w,328,42,40,2,294,238,56,0.9523809523809523
6020,0.1,True,0.012,31,True,vs_left,w,328,51,49,2,285,238,47,0.9607843137254902
6020,0.1,True,0.012,31,True,difference,w,328,1,0,1,335,239,96,0.0
6020,0.1,True,0.012,31,False,baseline,w,1271,6,0,6,1296,1200,96,0.0
6020,0.1,True,0.012,31,False,vs_right,w,1271,92,37,55,1210,1151,59,0.40217391304347827
6020,0.1,True,0.012,31,False,vs_left,w,1271,87,42,45,1215,1161,54,0.4827586206896552
6020,0.1,True,0.012,31,False,difference,w,1271,5,0,5,1297,1201,96,0.0
6020,0.1,True,0.02,86,True,baseline,w,700,0,0,0,728,504,224,0.0
6020,0.1,True,0.02,86,True,vs_right,w,700,75,68,7,653,497,156,0.9066666666666666
6020,0.1,True,0.02,86,True,vs_left,w,700,80,80,0,648,504,144,1.0
6020,0.1,True,0.02,86,True,difference,w,700,3,2,1,725,503,222,0.6666666666666666
6020,0.1,True,0.02,86,False,baseline,w,2150,2,0,2,2234,2010,224,0.0
6020,0.1,True,0.02,86,False,vs_right,w,2150,117,65,52,2119,1960,159,0.5555555555555556
6020,0.1,True,0.02,86,False,vs_left,w,2150,82,54,28,2154,1984,170,0.6585365853658537
6020,0.1,True,0.02,86,False,difference,w,2150,1,0,1,2235,2011,224,0.0
6020,0.1,True,0.02,64,True,baseline,w,450,0,0,0,468,324,144,0.0
6020,0.1,True,0.02,64,True,vs_right,w,450,54,51,3,414,321,93,0.9444444444444444
6020,0.1,True,0.02,64,True,vs_left,w,450,60,60,0,408,324,84,1.0
6020,0.1,True,0.02,64,True,difference,w,450,3,2,1,465,323,142,0.6666666666666666
6020,0.1,True,0.02,64,False,baseline,w,1600,2,0,2,1662,1518,144,0.0
6020,0.1,True,0.02,64,False,vs_right,w,1600,92,48,44,1572,1476,96,0.5217391304347826
6020,0.1,True,0.02,64,False,vs_left,w,1600,64,40,24,1600,1496,104,0.625
6020,0.1,True,0.02,64,False,difference,w,1600,1,0,1,1663,1519,144,0.0
6020,0.1,True,0.02,31,True,baseline,w,200,1,0,1,207,143,64,0.0
6020,0.1,True,0.02,31,True,vs_right,w,200,23,22,1,185,143,42,0.9565217391304348
6020,0.1,True,0.02,31,True,vs_left,w,200,24,24,0,184,144,40,1.0
6020,0.1,True,0.02,31,True,difference,w,200,1,0,1,207,143,64,0.0
6020,0.1,True,0.02,31,False,baseline,w,775,2,0,2,804,740,64,0.0
6020,0.1,True,0.02,31,False,vs_right,w,775,43,21,22,763,720,43,0.4883720930232558
6020,0.1,True,0.02,31,False,vs_left,w,775,37,23,14,769,728,41,0.6216216216216216
6020,0.1,True,0.02,31,False,difference,w,775,2,0,2,804,740,64,0.0
6020,0.1,True,0.004,86,True,baseline,b,3500,0,0,0,3528,2464,1064,0.0
6020,0.1,True,0.004,86,True,vs_right,b,3500,47,47,0,3481,2464,1017,1.0
6020,0.1,True,0.004,86,True,vs_left,b,3500,36,36,0,3492,2464,1028,1.0
6020,0.1,True,0.004,86,True,difference,b,3500,0,0,0,3528,2464,1064,0.0
6020,0.1,True,0.004,86,False,baseline,b,10750,0,0,0,10836,9772,1064,0.0
6020,0.1,True,0.004,86,False,vs_right,b,10750,16,9,7,10820,9765,1055,0.5625
6020,0.1,True,0.004,86,False,vs_left,b,10750,14,10,4,10822,9768,1054,0.7142857142857143
6020,0.1,True,0.004,86,False,difference,b,10750,0,0,0,10836,9772,1064,0.0
6020,0.1,True,0.004,64,True,baseline,b,2250,0,0,0,2268,1584,684,0.0
6020,0.1,True,0.004,64,True,vs_right,b,2250,46,46,0,2222,1584,638,1.0
6020,0.1,True,0.004,64,True,vs_left,b,2250,45,45,0,2223,1584,639,1.0
6020,0.1,True,0.004,64,True,difference,b,2250,0,0,0,2268,1584,684,0.0
6020,0.1,True,0.004,64,False,baseline,b,8000,0,0,0,8064,7380,684,0.0
6020,0.1,True,0.004,64,False,vs_right,b,8000,20,12,8,8044,7372,672,0.6
6020,0.1,True,0.004,64,False,vs_left,b,8000,15,11,4,8049,7376,673,0.7333333333333333
6020,0.1,True,0.004,64,False,difference,b,8000,0,0,0,8064,7380,684,0.0
6020,0.1,True,0.004,31,True,baseline,b,1000,0,0,0,1008,704,304,0.0
6020,0.1,True,0.004,31,True,vs_right,b,1000,25,25,0,983,704,279,1.0
6020,0.1,True,0.004,31,True,vs_left,b,1000,30,30,0,978,704,274,1.0
6020,0.1,True,0.004,31,True,difference,b,1000,0,0,0,1008,704,304,0.0
6020,0.1,True,0.004,31,False,baseline,b,3875,0,0,0,3906,3602,304,0.0
6020,0.1,True,0.004,31,False,vs_right,b,3875,28,15,13,3878,3589,289,0.5357142857142857
6020,0.1,True,0.004,31,False,vs_left,b,3875,12,8,4,3894,3598,296,0.6666666666666666
6020,0.1,True,0.004,31,False,difference,b,3875,0,0,0,3906,3602,304,0.0
6020,0.1,True,0.012,86,True,baseline,b,1148,0,0,0,1176,840,336,0.0
6020,0.1,True,0.012,86,True,vs_right,b,1148,22,22,0,1154,840,314,1.0
6020,0.1,True,0.012,86,True,vs_left,b,1148,35,35,0,1141,840,301,1.0
6020,0.1,True,0.012,86,True,difference,b,1148,0,0,0,1176,840,336,0.0
6020,0.1,True,0.012,86,False,baseline,b,3526,0,0,0,3612,3276,336,0.0
6020,0.1,True,0.012,86,False,vs_right,b,3526,19,14,5,3593,3271,322,0.7368421052631579
6020,0.1,True,0.012,86,False,vs_left,b,3526,15,11,4,3597,3272,325,0.7333333333333333
6020,0.1,True,0.012,86,False,difference,b,3526,0,0,0,3612,3276,336,0.0
6020,0.1,True,0.012,64,True,baseline,b,738,0,0,0,756,540,216,0.0
6020,0.1,True,0.012,64,True,vs_right,b,738,22,21,1,734,539,195,0.9545454545454546
6020,0.1,True,0.012,64,True,vs_left,b,738,29,29,0,727,540,187,1.0
6020,0.1,True,0.012,64,True,difference,b,738,0,0,0,756,540,216,0.0
6020,0.1,True,0.012,64,False,baseline,b,2624,0,0,0,2688,2472,216,0.0
6020,0.1,True,0.012,64,False,vs_right,b,2624,18,12,6,2670,2466,204,0.6666666666666666
6020,0.1,True,0.012,64,False,vs_left,b,2624,15,12,3,2673,2469,204,0.8
6020,0.1,True,0.012,64,False,difference,b,2624,0,0,0,2688,2472,216,0.0
6020,0.1,True,0.012,31,True,baseline,b,328,0,0,0,336,240,96,0.0
6020,0.1,True,0.012,31,True,vs_right,b,328,13,13,0,323,240,83,1.0
6020,0.1,True,0.012,31,True,vs_left,b,328,16,16,0,320,240,80,1.0
6020,0.1,True,0.012,31,True,difference,b,328,0,0,0,336,240,96,0.0
6020,0.1,True,0.012,31,False,baseline,b,1271,0,0,0,1302,1206,96,0.0
6020,0.1,True,0.012,31,False,vs_right,b,1271,13,8,5,1289,1201,88,0.6153846153846154
6020,0.1,True,0.012,31,False,vs_left,b,1271,13,10,3,1289,1203,86,0.7692307692307693
6020,0.1,True,0.012,31,False,difference,b,1271,0,0,0,1302,1206,96,0.0
6020,0.1,True,0.02,86,True,baseline,b,700,0,0,0,728,504,224,0.0
6020,0.1,True,0.02,86,True,vs_right,b,700,19,19,0,709,504,205,1.0
6020,0.1,True,0.02,86,True,vs_left,b,700,25,25,0,703,504,199,1.0
6020,0.1,True,0.02,86,True,difference,b,700,0,0,0,728,504,224,0.0
6020,0.1,True,0.02,86,False,baseline,b,2150,0,0,0,2236,2012,224,0.0
6020,0.1,True,0.02,86,False,vs_right,b,2150,21,16,5,2215,2007,208,0.7619047619047619
6020,0.1,True,0.02,86,False,vs_left,b,2150,18,16,2,2218,2010,208,0.8888888888888888
6020,0.1,True,0.02,86,False,difference,b,2150,0,0,0,2236,2012,224,0.0
6020,0.1,True,0.02,64,True,baseline,b,450,0,0,0,468,324,144,0.0
6020,0.1,True,0.02,64,True,vs_right,b,450,16,16,0,452,324,128,1.0
6020,0.1,True,0.02,64,True,vs_left,b,450,20,20,0,448,324,124,1.0
6020,0.1,True,0.02,64,True,difference,b,450,0,0,0,468,324,144,0.0
6020,0.1,True,0.02,64,False,baseline,b,1600,0,0,0,1664,1520,144,0.0
6020,0.1,True,0.02,64,False,vs_right,b,1600,17,12,5,1647,1515,132,0.7058823529411765
6020,0.1,True,0.02,64,False,vs_left,b,1600,18,15,3,1646,1517,129,0.8333333333333334
6020,0.1,True,0.02,64,False,difference,b,1600,0,0,0,1664,1520,144,0.0
6020,0.1,True,0.02,31,True,baseline,b,200,0,0,0,208,144,64,0.0
6020,0.1,True,0.02,31,True,vs_right,b,200,11,10,1,197,143,54,0.9090909090909091
6020,0.1,True,0.02,31,True,vs_left,b,200,11,11,0,197,144,53,1.0
6020,0.1,True,0.02,31,True,difference,b,200,0,0,0,208,144,64,0.0
6020,0.1,True,0.02,31,False,baseline,b,775,0,0,0,806,742,64,0.0
6020,0.1,True,0.02,31,False,vs_right,b,775,12,5,7,794,735,59,0.4166666666666667
6020,0.1,True,0.02,31,False,vs_left,b,775,11,8,3,795,739,56,0.7272727272727273
6020,0.1,True,0.02,31,False,difference,b,775,0,0,0,806,742,64,0.0
6020,0.1,False,0.004,86,True,baseline,w,3500,6,0,6,3522,2458,1064,0.0
6020,0.1,False,0.004,86,True,vs_right,w,3500,398,369,29,3130,2435,695,0.9271356783919598
6020,0.1,False,0.004,86,True,vs_left,w,3500,388,374,14,3140,2450,690,0.9639175257731959
6020,0.1,False,0.004,86,True,difference,w,3500,14,7,7,3514,2457,1057,0.5
6020,0.1,False,0.004,86,False,baseline,w,10750,17,0,17,10819,9755,1064,0.0
6020,0.1,False,0.004,86,False,vs_right,w,10750,547,313,234,10289,9538,751,0.5722120658135283
6020,0.1,False,0.004,86,False,vs_left,w,10750,540,330,210,10296,9562,734,0.6111111111111112
6020,0.1,False,0.004,86,False,difference,w,10750,11,2,9,10825,9763,1062,0.18181818181818182
6020,0.1,False,0.004,64,True,baseline,w,2250,2,0,2,2266,1582,684,0.0
6020,0.1,False,0.004,64,True,vs_right,w,2250,304,286,18,1964,1566,398,0.9407894736842105
6020,0.1,False,0.004,64,True,vs_left,w,2250,288,282,6,1980,1578,402,0.9791666666666666
6020,0.1,False,0.004,64,True,difference,w,2250,11,9,2,2257,1582,675,0.8181818181818182
6020,0.1,False,0.004,64,False,baseline,w,8000,13,0,13,8051,7367,684,0.0
6020,0.1,False,0.004,64,False,vs_right,w,8000,449,245,204,7615,7176,439,0.5456570155902004
6020,0.1,False,0.004,64,False,vs_left,w,8000,400,247,153,7664,7227,437,0.6175
6020,0.1,False,0.004,64,False,difference,w,8000,10,4,6,8054,7374,680,0.4
6020,0.1,False,0.004,31,True,baseline,w,1000,0,0,0,1008,704,304,0.0
6020,0.1,False,0.004,31,True,vs_right,w,1000,138,132,6,870,698,172,0.9565217391304348
6020,0.1,False,0.004,31,True,vs_left,w,1000,134,130,4,874,700,174,0.9701492537313433
6020,0.1,False,0.004,31,True,difference,w,1000,9,5,4,999,700,299,0.5555555555555556
6020,0.1,False,0.004,31,False,baseline,w,3875,9,0,9,3897,3593,304,0.0
6020,0.1,False,0.004,31,False,vs_right,w,3875,239,111,128,3667,3474,193,0.46443514644351463
6020,0.1,False,0.004,31,False,vs_left,w,3875,193,115,78,3713,3524,189,0.5958549222797928
6020,0.1,False,0.004,31,False,difference,w,3875,10,3,7,3896,3595,301,0.3
6020,0.1,False,0.012,86,True,baseline,w,1148,1,0,1,1175,839,336,0.0
6020,0.1,False,0.012,86,True,vs_right,w,1148,139,128,11,1037,829,208,0.920863309352518
6020,0.1,False,0.012,86,True,vs_left,w,1148,134,133,1,1042,839,203,0.9925373134328358
6020,0.1,False,0.012,86,True,difference,w,1148,8,2,6,1168,834,334,0.25
6020,0.1,False,0.012,86,False,baseline,w,3526,3,0,3,3609,3273,336,0.0
6020,0.1,False,0.012,86,False,vs_right,w,3526,194,118,76,3418,3200,218,0.6082474226804123
6020,0.1,False,0.012,86,False,vs_left,w,3526,166,104,62,3446,3214,232,0.6265060240963856
6020,0.1,False,0.012,86,False,difference,w,3526,5,0,5,3607,3271,336,0.0
6020,0.1,False,0.012,64,True,baseline,w,738,0,0,0,756,540,216,0.0
6020,0.1,False,0.012,64,True,vs_right,w,738,109,103,6,647,534,113,0.944954128440367
6020,0.1,False,0.012,64,True,vs_left,w,738,101,100,1,655,539,116,0.9900990099009901
6020,0.1,False,0.012,64,True,difference,w,738,6,2,4,750,536,214,0.3333333333333333
6020,0.1,False,0.012,64,False,baseline,w,2624,2,0,2,2686,2470,216,0.0
6020,0.1,False,0.012,64,False,vs_right,w,2624,159,92,67,2529,2405,124,0.5786163522012578
6020,0.1,False,0.012,64,False,vs_left,w,2624,133,82,51,2555,2421,134,0.6165413533834586
6020,0.1,False,0.012,64,False,difference,w,2624,3,0,3,2685,2469,216,0.0
6020,0.1,False,0.012,31,True,baseline,w,328,0,0,0,336,240,96,0.0
6020,0.1,False,0.012,31,True,vs_right,w,328,42,42,0,294,240,54,1.0
6020,0.1,False,0.012,31,True,vs_left,w,328,47,46,1,289,239,50,0.9787234042553191
6020,0.1,False,0.012,31,True,difference,w,328,4,2,2,332,238,94,0.5
6020,0.1,False,0.012,31,False,baseline,w,1271,4,0,4,1298,1202,96,0.0
6020,0.1,False,0.012,31,False,vs_right,w,1271,84,41,43,1218,1163,55,0.4880952380952381
6020,0.1,False,0.012,31,False,vs_left,w,1271,68,41,27,1234,1179,55,0.6029411764705882
6020,0.1,False,0.012,31,False,difference,w,1271,2,0,2,1300,1204,96,0.0
6020,0.1,False,0.02,86,True,baseline,w,700,2,0,2,726,502,224,0.0
6020,0.1,False,0.02,86,True,vs_right,w,700,66,64,2,662,502,160,0.9696969696969697
6020,0.1,False,0.02,86,True,vs_left,w,700,67,67,0,661,504,157,1.0
6020,0.1,False,0.02,86,True,difference,w,700,0,0,0,728,504,224,0.0
6020,0.1,False,0.02,86,False,baseline,w,2150,1,0,1,2235,2011,224,0.0
6020,0.1,False,0.02,86,False,vs_right,w,2150,95,59,36,2141,1976,165,0.6210526315789474
6020,0.1,False,0.02,86,False,vs_left,w,2150,67,46,21,2169,1991,178,0.6865671641791045
6020,0.1,False,0.02,86,False,difference,w,2150,1,0,1,2235,2011,224,0.0
6020,0.1,False,0.02,64,True,baseline,w,450,0,0,0,468,324,144,0.0
6020,0.1,False,0.02,64,True,vs_right,w,450,50,50,0,418,324,94,1.0
6020,0.1,False,0.02,64,True,vs_left,w,450,52,52,0,416,324,92,1.0
6020,0.1,False,0.02,64,True,difference,w,450,0,0,0,468,324,144,0.0
6020,0.1,False,0.02,64,False,baseline,w,1600,3,0,3,1661,1517,144,0.0
6020,0.1,False,0.02,64,False,vs_right,w,1600,78,47,31,1586,1489,97,0.6025641025641025
6020,0.1,False,0.02,64,False,vs_left,w,1600,51,36,15,1613,1505,108,0.7058823529411765
6020,0.1,False,0.02,64,False,difference,w,1600,1,0,1,1663,1519,144,0.0
6020,0.1,False,0.02,31,True,baseline,w,200,0,0,0,208,144,64,0.0
6020,0.1,False,0.02,31,True,vs_right,w,200,23,23,0,185,144,41,1.0
6020,0.1,False,0.02,31,True,vs_left,w,200,28,28,0,180,144,36,1.0
6020,0.1,False,0.02,31,True,difference,w,200,0,0,0,208,144,64,0.0
6020,0.1,False,0.02,31,False,baseline,w,775,4,0,4,802,738,64,0.0
6020,0.1,False,0.02,31,False,vs_right,w,775,32,21,11,774,731,43,0.65625
6020,0.1,False,0.02,31,False,vs_left,w,775,20,16,4,786,738,48,0.8
6020,0.1,False,0.02,31,False,difference,w,775,0,0,0,806,742,64,0.0
6020,0.1,False,0.004,86,True,baseline,b,3500,0,0,0,3528,2464,1064,0.0
6020,0.1,False,0.004,86,True,vs_right,b,3500,38,38,0,3490,2464,1026,1.0
6020,0.1,False,0.004,86,True,vs_left,b,3500,20,20,0,3508,2464,1044,1.0
6020,0.1,False,0.004,86,True,difference,b,3500,0,0,0,3528,2464,1064,0.0
6020,0.1,False,0.004,86,False,baseline,b,10750,0,0,0,10836,9772,1064,0.0
6020,0.1,False,0.004,86,False,vs_right,b,10750,17,11,6,10819,9766,1053,0.6470588235294118
6020,0.1,False,0.004,86,False,vs_left,b,10750,7,5,2,10829,9770,1059,0.7142857142857143
6020,0.1,False,0.004,86,False,difference,b,10750,0,0,0,10836,9772,1064,0.0
6020,0.1,False,0.004,64,True,baseline,b,2250,0,0,0,2268,1584,684,0.0
6020,0.1,False,0.004,64,True,vs_right,b,2250,38,38,0,2230,1584,646,1.0
6020,0.1,False,0.004,64,True,vs_left,b,2250,13,12,1,2255,1583,672,0.9230769230769231
6020,0.1,False,0.004,64,True,difference,b,2250,0,0,0,2268,1584,684,0.0
6020,0.1,False,0.004,64,False,baseline,b,8000,0,0,0,8064,7380,684,0.0
6020,0.1,False,0.004,64,False,vs_right,b,8000,13,11,2,8051,7378,673,0.8461538461538461
6020,0.1,False,0.004,64,False,vs_left,b,8000,4,0,4,8060,7376,684,0.0
6020,0.1,False,0.004,64,False,difference,b,8000,0,0,0,8064,7380,684,0.0
6020,0.1,False,0.004,31,True,baseline,b,1000,0,0,0,1008,704,304,0.0
6020,0.1,False,0.004,31,True,vs_right,b,1000,29,29,0,979,704,275,1.0
6020,0.1,False,0.004,31,True,vs_left,b,1000,14,14,0,994,704,290,1.0
6020,0.1,False,0.004,31,True,difference,b,1000,0,0,0,1008,704,304,0.0
6020,0.1,False,0.004,31,False,baseline,b,3875,0,0,0,3906,3602,304,0.0
6020,0.1,False,0.004,31,False,vs_right,b,3875,13,11,2,3893,3600,293,0.8461538461538461
6020,0.1,False,0.004,31,False,vs_left,b,3875,10,3,7,3896,3595,301,0.3
6020,0.1,False,0.004,31,False,difference,b,3875,0,0,0,3906,3602,304,0.0
6020,0.1,False,0.012,86,True,baseline,b,1148,0,0,0,1176,840,336,0.0
6020,0.1,False,0.012,86,True,vs_right,b,1148,26,26,0,1150,840,310,1.0
6020,0.1,False,0.012,86,True,vs_left,b,1148,24,23,1,1152,839,313,0.9583333333333334
6020,0.1,False,0.012,86,True,difference,b,1148,0,0,0,1176,840,336,0.0
6020,0.1,False,0.012,86,False,baseline,b,3526,0,0,0,3612,3276,336,0.0
6020,0.1,False,0.012,86,False,vs_right,b,3526,15,13,2,3597,3274,323,0.8666666666666667
6020,0.1,False,0.012,86,False,vs_left,b,3526,7,5,2,3605,3274,331,0.7142857142857143
6020,0.1,False,0.012,86,False,difference,b,3526,0,0,0,3612,3276,336,0.0
6020,0.1,False,0.012,64,True,baseline,b,738,0,0,0,756,540,216,0.0
6020,0.1,False,0.012,64,True,vs_right,b,738,21,21,0,735,540,195,1.0
6020,0.1,False,0.012,64,True,vs_left,b,738,19,18,1,737,539,198,0.9473684210526315
6020,0.1,False,0.012,64,True,difference,b,738,0,0,0,756,540,216,0.0
6020,0.1,False,0.012,64,False,baseline,b,2624,0,0,0,2688,2472,216,0.0
6020,0.1,False,0.012,64,False,vs_right,b,2624,12,11,1,2676,2471,205,0.9166666666666666
6020,0.1,False,0.012,64,False,vs_left,b,2624,7,3,4,2681,2468,213,0.42857142857142855
6020,0.1,False,0.012,64,False,difference,b,2624,0,0,0,2688,2472,216,0.0
6020,0.1,False,0.012,31,True,baseline,b,328,0,0,0,336,240,96,0.0
6020,0.1,False,0.012,31,True,vs_right,b,328,15,15,0,321,240,81,1.0
6020,0.1,False,0.012,31,True,vs_left,b,328,13,13,0,323,240,83,1.0
6020,0.1,False,0.012,31,True,difference,b,328,0,0,0,336,240,96,0.0
6020,0.1,False,0.012,31,False,baseline,b,1271,0,0,0,1302,1206,96,0.0
6020,0.1,False,0.012,31,False,vs_right,b,1271,7,7,0,1295,1206,89,1.0
6020,0.1,False,0.012,31,False,vs_left,b,1271,7,4,3,1295,1203,92,0.5714285714285714
6020,0.1,False,0.012,31,False,difference,b,1271,0,0,0,1302,1206,96,0.0
6020,0.1,False,0.02,86,True,baseline,b,700,0,0,0,728,504,224,0.0
6020,0.1,False,0.02,86,True,vs_right,b,700,22,22,0,706,504,202,1.0
6020,0.1,False,0.02,86,True,vs_left,b,700,23,23,0,705,504,201,1.0
6020,0.1,False,0.02,86,True,difference,b,700,0,0,0,728,504,224,0.0
6020,0.1,False,0.02,86,False,baseline,b,2150,0,0,0,2236,2012,224,0.0
6020,0.1,False,0.02,86,False,vs_right,b,2150,15,11,4,2221,2008,213,0.7333333333333333
6020,0.1,False,0.02,86,False,vs_left,b,2150,13,11,2,2223,2010,213,0.8461538461538461
6020,0.1,False,0.02,86,False,difference,b,2150,0,0,0,2236,2012,224,0.0
6020,0.1,False,0.02,64,True,baseline,b,450,0,0,0,468,324,144,0.0
6020,0.1,False,0.02,64,True,vs_right,b,450,20,20,0,448,324,124,1.0
6020,0.1,False,0.02,64,True,vs_left,b,450,19,19,0,449,324,125,1.0
6020,0.1,False,0.02,64,True,difference,b,450,0,0,0,468,324,144,0.0
6020,0.1,False,0.02,64,False,baseline,b,1600,0,0,0,1664,1520,144,0.0
6020,0.1,False,0.02,64,False,vs_right,b,1600,11,8,3,1653,1517,136,0.7272727272727273
6020,0.1,False,0.02,64,False,vs_left,b,1600,11,7,4,1653,1516,137,0.6363636363636364
6020,0.1,False,0.02,64,False,difference,b,1600,0,0,0,1664,1520,144,0.0
6020,0.1,False,0.02,31,True,baseline,b,200,0,0,0,208,144,64,0.0
6020,0.1,False,0.02,31,True,vs_right,b,200,10,10,0,198,144,54,1.0
6020,0.1,False,0.02,31,True,vs_left,b,200,9,9,0,199,144,55,1.0
6020,0.1,False,0.02,31,True,difference,b,200,0,0,0,208,144,64,0.0
6020,0.1,False,0.02,31,False,baseline,b,775,0,0,0,806,742,64,0.0
6020,0.1,False,0.02,31,False,vs_right,b,775,7,5,2,799,740,59,0.7142857142857143
6020,0.1,False,0.02,31,False,vs_left,b,775,9,6,3,797,739,58,0.6666666666666666
6020,0.1,False,0.02,31,False,difference,b,775,0,0,0,806,742,64,0.0
6020,0.2,True,0.004,86,True,baseline,w,3500,21,5,16,3507,2448,1059,0.23809523809523808
6020,0.2,True,0.004,86,True,vs_right,w,3500,485,443,42,3043,2422,621,0.9134020618556701
6020,0.2,True,0.004,86,True,vs_left,w,3500,472,460,12,3056,2452,604,0.9745762711864406
6020,0.2,True,0.004,86,True,difference,w,3500,23,21,2,3505,2462,1043,0.9130434782608695
6020,0.2,True,0.004,86,False,baseline,w,10750,18,3,15,10818,9757,1061,0.16666666666666666
6020,0.2,True,0.004,86,False,vs_right,w,10750,1069,407,662,9767,9110,657,0.3807296538821328
6020,0.2,True,0.004,86,False,vs_left,w,10750,1011,424,587,9825,9185,640,0.41938674579624136
6020,0.2,True,0.004,86,False,difference,w,10750,42,13,29,10794,9743,1051,0.30952380952380953
6020,0.2,True,0.004,64,True,baseline,w,2250,14,2,12,2254,1572,682,0.14285714285714285
6020,0.2,True,0.004,64,True,vs_right,w,2250,359,331,28,1909,1556,353,0.9220055710306406
6020,0.2,True,0.004,64,True,vs_left,w,2250,339,327,12,1929,1572,357,0.9646017699115044
6020,0.2,True,0.004,64,True,difference,w,2250,20,17,3,2248,1581,667,0.85
6020,0.2,True,0.004,64,False,baseline,w,8000,19,0,19,8045,7361,684,0.0
6020,0.2,True,0.004,64,False,vs_right,w,8000,812,295,517,7252,6863,389,0.3633004926108374
6020,0.2,True,0.004,64,False,vs_left,w,8000,776,300,476,7288,6904,384,0.3865979381443299
6020,0.2,True,0.004,64,False,difference,w,8000,32,10,22,8032,7358,674,0.3125
6020,0.2,True,0.004,31,True,baseline,w,1000,20,2,18,988,686,302,0.1
6020,0.2,True,0.004,31,True,vs_right,w,1000,176,154,22,832,682,150,0.875
6020,0.2,True,0.004,31,True,vs_left,w,1000,149,139,10,859,694,165,0.9328859060402684
6020,0.2,True,0.004,31,True,difference,w,1000,14,8,6,994,698,296,0.5714285714285714
6020,0.2,True,0.004,31,False,baseline,w,3875,19,0,19,3887,3583,304,0.0
6020,0.2,True,0.004,31,False,vs_right,w,3875,444,139,305,3462,3297,165,0.3130630630630631
6020,0.2,True,0.004,31,False,vs_left,w,3875,401,129,272,3505,3330,175,0.32169576059850374
6020,0.2,True,0.004,31,False,difference,w,3875,29,7,22,3877,3580,297,0.2413793103448276
6020,0.2,True,0.012,86,True,baseline,w,1148,3,0,3,1173,837,336,0.0
6020,0.2,True,0.012,86,True,vs_right,w,1148,173,156,17,1003,823,180,0.9017341040462428
6020,0.2,True,0.012,86,True,vs_left,w,1148,164,162,2,1012,838,174,0.9878048780487805
6020,0.2,True,0.012,86,True,difference,w,1148,8,6,2,1168,838,330,0.75
6020,0.2,True,0.012,86,False,baseline,w,3526,4,0,4,3608,3272,336,0.0
6020,0.2,True,0.012,86,False,vs_right,w,3526,389,143,246,3223,3030,193,0.3676092544987147
6020,0.2,True,0.012,86,False,vs_left,w,3526,349,145,204,3263,3072,191,0.4154727793696275
6020,0.2,True,0.012,86,False,difference,w,3526,15,4,11,3597,3265,332,0.26666666666666666
6020,0.2,True,0.012,64,True,baseline,w,738,3,0,3,753,537,216,0.0
6020,0.2,True,0.012,64,True,vs_right,w,738,119,110,9,637,531,106,0.9243697478991597
6020,0.2,True,0.012,64,True,vs_left,w,738,122,122,0,634,540,94,1.0
6020,0.2,True,0.012,64,True,difference,w,738,8,6,2,748,538,210,0.75
6020,0.2,True,0.012,64,False,baseline,w,2624,5,0,5,2683,2467,216,0.0
6020,0.2,True,0.012,64,False,vs_right,w,2624,301,105,196,2387,2276,111,0.3488372093023256
6020,0.2,True,0.012,64,False,vs_left,w,2624,270,101,169,2418,2303,115,0.37407407407407406
6020,0.2,True,0.012,64,False,difference,w,2624,14,4,10,2674,2462,212,0.2857142857142857
6020,0.2,True,0.012,31,True,baseline,w,328,6,0,6,330,234,96,0.0
6020,0.2,True,0.012,31,True,vs_right,w,328,60,52,8,276,232,44,0.8666666666666667
6020,0.2,True,0.012,31,True,vs_left,w,328,55,55,0,281,240,41,1.0
6020,0.2,True,0.012,31,True,difference,w,328,6,4,2,330,238,92,0.6666666666666666
6020,0.2,True,0.012,31,False,baseline,w,1271,5,0,5,1297,1201,96,0.0
6020,0.2,True,0.012,31,False,vs_right,w,1271,164,49,115,1138,1091,47,0.29878048780487804
6020,0.2,True,0.012,31,False,vs_left,w,1271,140,45,95,1162,1111,51,0.32142857142857145
6020,0.2,True,0.012,31,False,difference,w,1271,7,4,3,1295,1203,92,0.5714285714285714
6020,0.2,True,0.02,86,True,baseline,w,700,2,0,2,726,502,224,0.0
6020,0.2,True,0.02,86,True,vs_right,w,700,99,91,8,629,496,133,0.9191919191919192
6020,0.2,True,0.02,86,True,vs_left,w,700,84,84,0,644,504,140,1.0
6020,0.2,True,0.02,86,True,difference,w,700,2,2,0,726,504,222,1.0
6020,0.2,True,0.02,86,False,baseline,w,2150,2,0,2,2234,2010,224,0.0
6020,0.2,True,0.02,86,False,vs_right,w,2150,201,86,115,2035,1897,138,0.42786069651741293
6020,0.2,True,0.02,86,False,vs_left,w,2150,135,66,69,2101,1943,158,0.4888888888888889
6020,0.2,True,0.02,86,False,difference,w,2150,4,2,2,2232,2010,222,0.5
6020,0.2,True,0.02,64,True,baseline,w,450,2,0,2,466,322,144,0.0
6020,0.2,True,0.02,64,True,vs_right,w,450,65,63,2,403,322,81,0.9692307692307692
6020,0.2,True,0.02,64,True,vs_left,w,450,62,62,0,406,324,82,1.0
6020,0.2,True,0.02,64,True,difference,w,450,2,2,0,466,324,142,1.0
6020,0.2,True,0.02,64,False,baseline,w,1600,2,0,2,1662,1518,144,0.0
6020,0.2,True,0.02,64,False,vs_right,w,1600,156,60,96,1508,1424,84,0.38461538461538464
6020,0.2,True,0.02,64,False,vs_left,w,1600,100,47,53,1564,1467,97,0.47
6020,0.2,True,0.02,64,False,difference,w,1600,4,2,2,1660,1518,142,0.5
6020,0.2,True,0.02,31,True,baseline,w,200,2,0,2,206,142,64,0.0
6020,0.2,True,0.02,31,True,vs_right,w,200,36,30,6,172,138,34,0.8333333333333334
6020,0.2,True,0.02,31,True,vs_left,w,200,34,32,2,174,142,32,0.9411764705882353
6020,0.2,True,0.02,31,True,difference,w,200,2,2,0,206,144,62,1.0
6020,0.2,True,0.02,31,False,baseline,w,775,2,0,2,804,740,64,0.0
6020,0.2,True,0.02,31,False,vs_right,w,775,83,28,55,723,687,36,0.3373493975903614
6020,0.2,True,0.02,31,False,vs_left,w,775,53,19,34,753,708,45,0.3584905660377358
6020,0.2,True,0.02,31,False,difference,w,775,1,0,1,805,741,64,0.0
6020,0.2,True,0.004,86,True,baseline,b,3500,0,0,0,3528,2464,1064,0.0
6020,0.2,True,0.004,86,True,vs_right,b,3500,56,56,0,3472,2464,1008,1.0
6020,0.2,True,0.004,86,True,vs_left,b,3500,39,39,0,3489,2464,1025,1.0
6020,0.2,True,0.004,86,True,difference,b,3500,0,0,0,3528,2464,1064,0.0
6020,0.2,True,0.004,86,False,baseline,b,10750,0,0,0,10836,9772,1064,0.0
6020,0.2,True,0.004,86,False,vs_right,b,10750,35,5,30,10801,9742,1059,0.14285714285714285
6020,0.2,True,0.004,86,False,vs_left,b,10750,17,3,14,10819,9758,1061,0.17647058823529413
6020,0.2,True,0.004,86,False,difference,b,10750,0,0,0,10836,9772,1064,0.0
6020,0.2,True,0.004,64,True,baseline,b,2250,0,0,0,2268,1584,684,0.0
6020,0.2,True,0.004,64,True,vs_right,b,2250,53,53,0,2215,1584,631,1.0
6020,0.2,True,0.004,64,True,vs_left,b,2250,55,55,0,2213,1584,629,1.0
6020,0.2,True,0.004,64,True,difference,b,2250,1,1,0,2267,1584,683,1.0
6020,0.2,True,0.004,64,False,baseline,b,8000,0,0,0,8064,7380,684,0.0
6020,0.2,True,0.004,64,False,vs_right,b,8000,26,7,19,8038,7361,677,0.2692307692307692
6020,0.2,True,0.004,64,False,vs_left,b,8000,24,6,18,8040,7362,678,0.25
6020,0.2,True,0.004,64,False,difference,b,8000,0,0,0,8064,7380,684,0.0
6020,0.2,True,0.004,31,True,baseline,b,1000,0,0,0,1008,704,304,0.0
6020,0.2,True,0.004,31,True,vs_right,b,1000,33,33,0,975,704,271,1.0
6020,0.2,True,0.004,31,True,vs_left,b,1000,48,48,0,960,704,256,1.0
6020,0.2,True,0.004,31,True,difference,b,1000,0,0,0,1008,704,304,0.0
6020,0.2,True,0.004,31,False,baseline,b,3875,0,0,0,3906,3602,304,0.0
6020,0.2,True,0.004,31,False,vs_right,b,3875,30,12,18,3876,3584,292,0.4
6020,0.2,True,0.004,31,False,vs_left,b,3875,29,12,17,3877,3585,292,0.41379310344827586
6020,0.2,True,0.004,31,False,difference,b,3875,0,0,0,3906,3602,304,0.0
6020,0.2,True,0.012,86,True,baseline,b,1148,0,0,0,1176,840,336,0.0
6020,0.2,True,0.012,86,True,vs_right,b,1148,32,32,0,1144,840,304,1.0
6020,0.2,True,0.012,86,True,vs_left,b,1148,50,50,0,1126,840,286,1.0
6020,0.2,True,0.012,86,True,difference,b,1148,0,0,0,1176,840,336,0.0
6020,0.2,True,0.012,86,False,baseline,b,3526,0,0,0,3612,3276,336,0.0
6020,0.2,True,0.012,86,False,vs_right,b,3526,36,18,18,3576,3258,318,0.5
6020,0.2,True,0.012,86,False,vs_left,b,3526,27,11,16,3585,3260,325,0.4074074074074074
6020,0.2,True,0.012,86,False,difference,b,3526,0,0,0,3612,3276,336,0.0
6020,0.2,True,0.012,64,True,baseline,b,738,0,0,0,756,540,216,0.0
6020,0.2,True,0.012,64,True,vs_right,b,738,28,28,0,728,540,188,1.0
6020,0.2,True,0.012,64,True,vs_left,b,738,42,42,0,714,540,174,1.0
6020,0.2,True,0.012,64,True,difference,b,738,0,0,0,756,540,216,0.0
6020,0.2,True,0.012,64,False,baseline,b,2624,0,0,0,2688,2472,216,0.0
6020,0.2,True,0.012,64,False,vs_right,b,2624,29,15,14,2659,2458,201,0.5172413793103449
6020,0.2,True,0.012,64,False,vs_left,b,2624,31,16,15,2657,2457,200,0.5161290322580645
6020,0.2,True,0.012,64,False,difference,b,2624,0,0,0,2688,2472,216,0.0
6020,0.2,True,0.012,31,True,baseline,b,328,0,0,0,336,240,96,0.0
6020,0.2,True,0.012,31,True,vs_right,b,328,19,19,0,317,240,77,1.0
6020,0.2,True,0.012,31,True,vs_left,b,328,24,24,0,312,240,72,1.0
6020,0.2,True,0.012,31,True,difference,b,328,0,0,0,336,240,96,0.0
6020,0.2,True,0.012,31,False,baseline,b,1271,0,0,0,1302,1206,96,0.0
6020,0.2,True,0.012,31,False,vs_right,b,1271,17,8,9,1285,1197,88,0.47058823529411764
6020,0.2,True,0.012,31,False,vs_left,b,1271,27,15,12,1275,1194,81,0.5555555555555556
6020,0.2,True,0.012,31,False,difference,b,1271,0,0,0,1302,1206,96,0.0
6020,0.2,True,0.02,86,True,baseline,b,700,0,0,0,728,504,224,0.0
6020,0.2,True,0.02,86,True,vs_right,b,700,23,23,0,705,504,201,1.0
6020,0.2,True,0.02,86,True,vs_left,b,700,38,38,0,690,504,186,1.0
6020,0.2,True,0.02,86,True,difference,b,700,0,0,0,728,504,224,0.0
6020,0.2,True,0.02,86,False,baseline,b,2150,0,0,0,2236,2012,224,0.0
6020,0.2,True,0.02,86,False,vs_right,b,2150,41,21,20,2195,1992,203,0.5121951219512195
6020,0.2,True,0.02,86,False,vs_left,b,2150,41,26,15,2195,1997,198,0.6341463414634146
6020,0.2,True,0.02,86,False,difference,b,2150,0,0,0,2236,2012,224,0.0
6020,0.2,True,0.02,64,True,baseline,b,450,0,0,0,468,324,144,0.0
6020,0.2,True,0.02,64,True,vs_right,b,450,25,25,0,443,324,119,1.0
6020,0.2,True,0.02,64,True,vs_left,b,450,31,31,0,437,324,113,1.0
6020,0.2,True,0.02,64,True,difference,b,450,0,0,0,468,324,144,0.0
6020,0.2,True,0.02,64,False,baseline,b,1600,0,0,0,1664,1520,144,0.0
6020,0.2,True,0.02,64,False,vs_right,b,1600,28,15,13,1636,1507,129,0.5357142857142857
6020,0.2,True,0.02,64,False,vs_left,b,1600,39,25,14,1625,1506,119,0.6410256410256411
6020,0.2,True,0.02,64,False,difference,b,1600,0,0,0,1664,1520,144,0.0
6020,0.2,True,0.02,31,True,baseline,b,200,0,0,0,208,144,64,0.0
6020,0.2,True,0.02,31,True,vs_right,b,200,15,15,0,193,144,49,1.0
6020,0.2,True,0.02,31,True,vs_left,b,200,14,14,0,194,144,50,1.0
6020,0.2,True,0.02,31,True,difference,b,200,0,0,0,208,144,64,0.0
6020,0.2,True,0.02,31,False,baseline,b,775,0,0,0,806,742,64,0.0
6020,0.2,True,0.02,31,False,vs_right,b,775,13,6,7,793,735,58,0.46153846153846156
6020,0.2,True,0.02,31,False,vs_left,b,775,27,14,13,779,729,50,0.5185185185185185
6020,0.2,True,0.02,31,False,difference,b,775,0,0,0,806,742,64,0.0
6020,0.2,False,0.004,86,True,baseline,w,3500,7,5,2,3521,2462,1059,0.7142857142857143
6020,0.2,False,0.004,86,True,vs_right,w,3500,461,431,30,3067,2434,633,0.9349240780911063
6020,0.2,False,0.004,86,True,vs_left,w,3500,457,450,7,3071,2457,614,0.9846827133479212
6020,0.2,False,0.004,86,True,difference,w,3500,22,17,5,3506,2459,1047,0.7727272727272727
6020,0.2,False,0.004,86,False,baseline,w,10750,7,3,4,10829,9768,1061,0.42857142857142855
6020,0.2,False,0.004,86,False,vs_right,w,10750,956,373,583,9880,9189,691,0.3901673640167364
6020,0.2,False,0.004,86,False,vs_left,w,10750,936,404,532,9900,9240,660,0.43162393162393164
6020,0.2,False,0.004,86,False,difference,w,10750,24,14,10,10812,9762,1050,0.5833333333333334
6020,0.2,False,0.004,64,True,baseline,w,2250,9,5,4,2259,1580,679,0.5555555555555556
6020,0.2,False,0.004,64,True,vs_right,w,2250,349,323,26,1919,1558,361,0.9255014326647565
6020,0.2,False,0.004,64,True,vs_left,w,2250,336,326,10,1932,1574,358,0.9702380952380952
6020,0.2,False,0.004,64,True,difference,w,2250,18,11,7,2250,1577,673,0.6111111111111112
6020,0.2,False,0.004,64,False,baseline,w,8000,8,3,5,8056,7375,681,0.375
6020,0.2,False,0.004,64,False,vs_right,w,8000,753,284,469,7311,6911,400,0.37715803452855245
6020,0.2,False,0.004,64,False,vs_left,w,8000,730,299,431,7334,6949,385,0.4095890410958904
6020,0.2,False,0.004,64,False,difference,w,8000,21,10,11,8043,7369,674,0.47619047619047616
6020,0.2,False,0.004,31,True,baseline,w,1000,6,2,4,1002,700,302,0.3333333333333333
6020,0.2,False,0.004,31,True,vs_right,w,1000,164,150,14,844,690,154,0.9146341463414634
6020,0.2,False,0.004,31,True,vs_left,w,1000,159,146,13,849,691,158,0.9182389937106918
6020,0.2,False,0.004,31,True,difference,w,1000,19,9,10,989,694,295,0.47368421052631576
6020,0.2,False,0.004,31,False,baseline,w,3875,7,0,7,3899,3595,304,0.0
6020,0.2,False,0.004,31,False,vs_right,w,3875,406,134,272,3500,3330,170,0.33004926108374383
6020,0.2,False,0.004,31,False,vs_left,w,3875,353,129,224,3553,3378,175,0.3654390934844193
6020,0.2,False,0.004,31,False,difference,w,3875,18,6,12,3888,3590,298,0.3333333333333333
6020,0.2,False,0.012,86,True,baseline,w,1148,1,0,1,1175,839,336,0.0
6020,0.2,False,0.012,86,True,vs_right,w,1148,162,149,13,1014,827,187,0.9197530864197531
6020,0.2,False,0.012,86,True,vs_left,w,1148,165,163,2,1011,838,173,0.9878787878787879
6020,0.2,False,0.012,86,True,difference,w,1148,6,6,0,1170,840,330,1.0
6020,0.2,False,0.012,86,False,baseline,w,3526,1,0,1,3611,3275,336,0.0
6020,0.2,False,0.012,86,False,vs_right,w,3526,358,136,222,3254,3054,200,0.37988826815642457
6020,0.2,False,0.012,86,False,vs_left,w,3526,337,142,195,3275,3081,194,0.42136498516320475
6020,0.2,False,0.012,86,False,difference,w,3526,6,4,2,3606,3274,332,0.6666666666666666
6020,0.2,False,0.012,64,True,baseline,w,738,1,0,1,755,539,216,0.0
6020,0.2,False,0.012,64,True,vs_right,w,738,119,109,10,637,530,107,0.9159663865546218
6020,0.2,False,0.012,64,True,vs_left,w,738,121,118,3,635,537,98,0.9752066115702479
6020,0.2,False,0.012,64,True,difference,w,738,6,4,2,750,538,212,0.6666666666666666
6020,0.2,False,0.012,64,False,baseline,w,2624,1,0,1,2687,2471,216,0.0
6020,0.2,False,0.012,64,False,vs_right,w,2624,284,103,181,2404,2291,113,0.3626760563380282
6020,0.2,False,0.012,64,False,vs_left,w,2624,256,101,155,2432,2317,115,0.39453125
6020,0.2,False,0.012,64,False,difference,w,2624,6,2,4,2682,2468,214,0.3333333333333333
6020,0.2,False,0.012,31,True,baseline,w,328,1,0,1,335,239,96,0.0
6020,0.2,False,0.012,31,True,vs_right,w,328,63,52,11,273,229,44,0.8253968253968254
6020,0.2,False,0.012,31,True,vs_left,w,328,55,52,3,281,237,44,0.9454545454545454
6020,0.2,False,0.012,31,True,difference,w,328,5,2,3,331,237,94,0.4
6020,0.2,False,0.012,31,False,baseline,w,1271,1,0,1,1301,1205,96,0.0
6020,0.2,False,0.012,31,False,vs_right,w,1271,148,46,102,1154,1104,50,0.3108108108108108
6020,0.2,False,0.012,31,False,vs_left,w,1271,123,44,79,1179,1127,52,0.35772357723577236
6020,0.2,False,0.012,31,False,difference,w,1271,4,2,2,1298,1204,94,0.5
6020,0.2,False,0.02,86,True,baseline,w,700,1,0,1,727,503,224,0.0
6020,0.2,False,0.02,86,True,vs_right,w,700,88,85,3,640,501,139,0.9659090909090909
6020,0.2,False,0.02,86,True,vs_left,w,700,76,76,0,652,504,148,1.0
6020,0.2,False,0.02,86,True,difference,w,700,2,2,0,726,504,222,1.0
6020,0.2,False,0.02,86,False,baseline,w,2150,1,0,1,2235,2011,224,0.0
6020,0.2,False,0.02,86,False,vs_right,w,2150,192,78,114,2044,1898,146,0.40625
6020,0.2,False,0.02,86,False,vs_left,w,2150,129,62,67,2107,1945,162,0.4806201550387597
6020,0.2,False,0.02,86,False,difference,w,2150,0,0,0,2236,2012,224,0.0
6020,0.2,False,0.02,64,True,baseline,w,450,1,0,1,467,323,144,0.0
6020,0.2,False,0.02,64,True,vs_right,w,450,67,64,3,401,321,80,0.9552238805970149
6020,0.2,False,0.02,64,True,vs_left,w,450,71,67,4,397,320,77,0.9436619718309859
6020,0.2,False,0.02,64,True,difference,w,450,3,2,1,465,323,142,0.6666666666666666
6020,0.2,False,0.02,64,False,baseline,w,1600,1,0,1,1663,1519,144,0.0
6020,0.2,False,0.02,64,False,vs_right,w,1600,157,58,99,1507,1421,86,0.36942675159235666
6020,0.2,False,0.02,64,False,vs_left,w,1600,106,48,58,1558,1462,96,0.4528301886792453
6020,0.2,False,0.02,64,False,difference,w,1600,0,0,0,1664,1520,144,0.0
6020,0.2,False,0.02,31,True,baseline,w,200,1,0,1,207,143,64,0.0
6020,0.2,False,0.02,31,True,vs_right,w,200,33,30,3,175,141,34,0.9090909090909091
6020,0.2,False,0.02,31,True,vs_left,w,200,35,31,4,173,140,33,0.8857142857142857
6020,0.2,False,0.02,31,True,difference,w,200,3,2,1,205,143,62,0.6666666666666666
6020,0.2,False,0.02,31,False,baseline,w,775,1,0,1,805,741,64,0.0
6020,0.2,False,0.02,31,False,vs_right,w,775,82,28,54,724,688,36,0.34146341463414637
6020,0.2,False,0.02,31,False,vs_left,w,775,49,18,31,757,711,46,0.3673469387755102
6020,0.2,False,0.02,31,False,difference,w,775,2,2,0,804,742,62,1.0
6020,0.2,False,0.004,86,True,baseline,b,3500,0,0,0,3528,2464,1064,0.0
6020,0.2,False,0.004,86,True,vs_right,b,3500,41,41,0,3487,2464,1023,1.0
6020,0.2,False,0.004,86,True,vs_left,b,3500,43,43,0,3485,2464,1021,1.0
6020,0.2,False,0.004,86,True,difference,b,3500,0,0,0,3528,2464,1064,0.0
6020,0.2,False,0.004,86,False,baseline,b,10750,0,0,0,10836,9772,1064,0.0
6020,0.2,False,0.004,86,False,vs_right,b,10750,29,9,20,10807,9752,1055,0.3103448275862069
6020,0.2,False,0.004,86,False,vs_left,b,10750,12,1,11,10824,9761,1063,0.08333333333333333
6020,0.2,False,0.004,86,False,difference,b,10750,0,0,0,10836,9772,1064,0.0
6020,0.2,False,0.004,64,True,baseline,b,2250,0,0,0,2268,1584,684,0.0
6020,0.2,False,0.004,64,True,vs_right,b,2250,41,41,0,2227,1584,643,1.0
6020,0.2,False,0.004,64,True,vs_left,b,2250,55,55,0,2213,1584,629,1.0
6020,0.2,False,0.004,64,True,difference,b,2250,0,0,0,2268,1584,684,0.0
6020,0.2,False,0.004,64,False,baseline,b,8000,0,0,0,8064,7380,684,0.0
6020,0.2,False,0.004,64,False,vs_right,b,8000,31,12,19,8033,7361,672,0.3870967741935484
6020,0.2,False,0.004,64,False,vs_left,b,8000,11,4,7,8053,7373,680,0.36363636363636365
6020,0.2,False,0.004,64,False,difference,b,8000,0,0,0,8064,7380,684,0.0
6020,0.2,False,0.004,31,True,baseline,b,1000,0,0,0,1008,704,304,0.0
6020,0.2,False,0.004,31,True,vs_right,b,1000,32,32,0,976,704,272,1.0
6020,0.2,False,0.004,31,True,vs_left,b,1000,37,37,0,971,704,267,1.0
6020,0.2,False,0.004,31,True,difference,b,1000,0,0,0,1008,704,304,0.0
6020,0.2,False,0.004,31,False,baseline,b,3875,0,0,0,3906,3602,304,0.0
6020,0.2,False,0.004,31,False,vs_right,b,3875,31,15,16,3875,3586,289,0.4838709677419355
6020,0.2,False,0.004,31,False,vs_left,b,3875,24,13,11,3882,3591,291,0.5416666666666666
6020,0.2,False,0.004,31,False,difference,b,3875,0,0,0,3906,3602,304,0.0
6020,0.2,False,0.012,86,True,baseline,b,1148,0,0,0,1176,840,336,0.0
6020,0.2,False,0.012,86,True,vs_right,b,1148,27,27,0,1149,840,309,1.0
6020,0.2,False,0.012,86,True,vs_left,b,1148,40,40,0,1136,840,296,1.0
6020,0.2,False,0.012,86,True,difference,b,1148,0,0,0,1176,840,336,0.0
6020,0.2,False,0.012,86,False,baseline,b,3526,0,0,0,3612,3276,336,0.0
6020,0.2,False,0.012,86,False,vs_right,b,3526,27,13,14,3585,3262,323,0.48148148148148145
6020,0.2,False,0.012,86,False,vs_left,b,3526,18,11,7,3594,3269,325,0.6111111111111112
6020,0.2,False,0.012,86,False,difference,b,3526,0,0,0,3612,3276,336,0.0
6020,0.2,False,0.012,64,True,baseline,b,738,0,0,0,756,540,216,0.0
6020,0.2,False,0.012,64,True,vs_right,b,738,26,26,0,730,540,190,1.0
6020,0.2,False,0.012,64,True,vs_left,b,738,40,40,0,716,540,176,1.0
6020,0.2,False,0.012,64,True,difference,b,738,0,0,0,756,540,216,0.0
6020,0.2,False,0.012,64,False,baseline,b,2624,0,0,0,2688,2472,216,0.0
6020,0.2,False,0.012,64,False,vs_right,b,2624,28,12,16,2660,2456,204,0.42857142857142855
6020,0.2,False,0.012,64,False,vs_left,b,2624,20,15,5,2668,2467,201,0.75
6020,0.2,False,0.012,64,False,difference,b,2624,0,0,0,2688,2472,216,0.0
6020,0.2,False,0.012,31,True,baseline,b,328,0,0,0,336,240,96,0.0
6020,0.2,False,0.012,31,True,vs_right,b,328,16,16,0,320,240,80,1.0
6020,0.2,False,0.012,31,True,vs_left,b,328,24,24,0,312,240,72,1.0
6020,0.2,False,0.012,31,True,difference,b,328,0,0,0,336,240,96,0.0
6020,0.2,False,0.012,31,False,baseline,b,1271,0,0,0,1302,1206,96,0.0
6020,0.2,False,0.012,31,False,vs_right,b,1271,23,11,12,1279,1194,85,0.4782608695652174
6020,0.2,False,0.012,31,False,vs_left,b,1271,24,14,10,1278,1196,82,0.5833333333333334
6020,0.2,False,0.012,31,False,difference,b,1271,0,0,0,1302,1206,96,0.0
6020,0.2,False,0.02,86,True,baseline,b,700,0,0,0,728,504,224,0.0
6020,0.2,False,0.02,86,True,vs_right,b,700,20,20,0,708,504,204,1.0
6020,0.2,False,0.02,86,True,vs_left,b,700,38,38,0,690,504,186,1.0
6020,0.2,False,0.02,86,True,difference,b,700,0,0,0,728,504,224,0.0
6020,0.2,False,0.02,86,False,baseline,b,2150,0,0,0,2236,2012,224,0.0
6020,0.2,False,0.02,86,False,vs_right,b,2150,25,13,12,2211,2000,211,0.52
6020,0.2,False,0.02,86,False,vs_left,b,2150,37,25,12,2199,2000,199,0.6756756756756757
6020,0.2,False,0.02,86,False,difference,b,2150,1,0,1,2235,2011,224,0.0
6020,0.2,False,0.02,64,True,baseline,b,450,1,1,0,467,324,143,1.0
6020,0.2,False,0.02,64,True,vs_right,b,450,20,20,0,448,324,124,1.0
6020,0.2,False,0.02,64,True,vs_left,b,450,30,30,0,438,324,114,1.0
6020,0.2,False,0.02,64,True,difference,b,450,0,0,0,468,324,144,0.0
6020,0.2,False,0.02,64,False,baseline,b,1600,0,0,0,1664,1520,144,0.0
6020,0.2,False,0.02,64,False,vs_right,b,1600,23,12,11,1641,1509,132,0.5217391304347826
6020,0.2,False,0.02,64,False,vs_left,b,1600,32,20,12,1632,1508,124,0.625
6020,0.2,False,0.02,64,False,difference,b,1600,1,0,1,1663,1519,144,0.0
6020,0.2,False,0.02,31,True,baseline,b,200,0,0,0,208,144,64,0.0
6020,0.2,False,0.02,31,True,vs_right,b,200,12,12,0,196,144,52,1.0
6020,0.2,False,0.02,31,True,vs_left,b,200,13,13,0,195,144,51,1.0
6020,0.2,False,0.02,31,True,difference,b,200,0,0,0,208,144,64,0.0
6020,0.2,False,0.02,31,False,baseline,b,775,0,0,0,806,742,64,0.0
6020,0.2,False,0.02,31,False,vs_right,b,775,17,6,11,789,731,58,0.35294117647058826
6020,0.2,False,0.02,31,False,vs_left,b,775,19,11,8,787,734,53,0.5789473684210527
6020,0.2,False,0.02,31,False,difference,b,775,0,0,0,806,742,64,0.0
8040,0.1,True,0.004,86,True,baseline,w,3500,15,5,10,3513,2454,1059,0.3333333333333333
8040,0.1,True,0.004,86,True,vs_right,w,3500,441,409,32,3087,2432,655,0.927437641723356
8040,0.1,True,0.004,86,True,vs_left,w,3500,432,432,0,3096,2464,632,1.0
8040,0.1,True,0.004,86,True,difference,w,3500,11,9,2,3517,2462,1055,0.8181818181818182
8040,0.1,True,0.004,86,False,baseline,w,10750,26,2,24,10810,9748,1062,0.07692307692307693
8040,0.1,True,0.004,86,False,vs_right,w,10750,850,367,483,9986,9289,697,0.43176470588235294
8040,0.1,True,0.004,86,False,vs_left,w,10750,858,390,468,9978,9304,674,0.45454545454545453
8040,0.1,True,0.004,86,False,difference,w,10750,14,4,10,10822,9762,1060,0.2857142857142857
8040,0.1,True,0.004,64,True,baseline,w,2250,15,4,11,2253,1573,680,0.26666666666666666
8040,0.1,True,0.004,64,True,vs_right,w,2250,332,303,29,1936,1555,381,0.9126506024096386
8040,0.1,True,0.004,64,True,vs_left,w,2250,323,319,4,1945,1580,365,0.9876160990712074
8040,0.1,True,0.004,64,True,difference,w,2250,12,9,3,2256,1581,675,0.75
8040,0.1,True,0.004,64,False,baseline,w,8000,26,2,24,8038,7356,682,0.07692307692307693
8040,0.1,True,0.004,64,False,vs_right,w,8000,649,270,379,7415,7001,414,0.41602465331278893
8040,0.1,True,0.004,64,False,vs_left,w,8000,669,280,389,7395,6991,404,0.41853512705530643
8040,0.1,True,0.004,64,False,difference,w,8000,12,4,8,8052,7372,680,0.3333333333333333
8040,0.1,True,0.004,31,True,baseline,w,1000,14,4,10,994,694,300,0.2857142857142857
8040,0.1,True,0.004,31,True,vs_right,w,1000,153,133,20,855,684,171,0.869281045751634
8040,0.1,True,0.004,31,True,vs_left,w,1000,151,147,4,857,700,157,0.9735099337748344
8040,0.1,True,0.004,31,True,difference,w,1000,10,6,4,998,700,298,0.6
8040,0.1,True,0.004,31,False,baseline,w,3875,21,3,18,3885,3584,301,0.14285714285714285
8040,0.1,True,0.004,31,False,vs_right,w,3875,296,110,186,3610,3416,194,0.3716216216216216
8040,0.1,True,0.004,31,False,vs_left,w,3875,355,130,225,3551,3377,174,0.36619718309859156
8040,0.1,True,0.004,31,False,difference,w,3875,3,3,0,3903,3602,301,1.0
8040,0.1,True,0.012,86,True,baseline,w,1148,1,0,1,1175,839,336,0.0
8040,0.1,True,0.012,86,True,vs_right,w,1148,156,145,11,1020,829,191,0.9294871794871795
8040,0.1,True,0.012,86,True,vs_left,w,1148,157,157,0,1019,840,179,1.0
8040,0.1,True,0.012,86,True,difference,w,1148,2,2,0,1174,840,334,1.0
8040,0.1,True,0.012,86,False,baseline,w,3526,0,0,0,3612,3276,336,0.0
8040,0.1,True,0.012,86,False,vs_right,w,3526,289,131,158,3323,3118,205,0.4532871972318339
8040,0.1,True,0.012,86,False,vs_left,w,3526,299,139,160,3313,3116,197,0.46488294314381273
8040,0.1,True,0.012,86,False,difference,w,3526,2,0,2,3610,3274,336,0.0
8040,0.1,True,0.012,64,True,baseline,w,738,0,0,0,756,540,216,0.0
8040,0.1,True,0.012,64,True,vs_right,w,738,123,106,17,633,523,110,0.8617886178861789
8040,0.1,True,0.012,64,True,vs_left,w,738,115,115,0,641,540,101,1.0
8040,0.1,True,0.012,64,True,difference,w,738,4,4,0,752,540,212,1.0
8040,0.1,True,0.012,64,False,baseline,w,2624,4,0,4,2684,2468,216,0.0
8040,0.1,True,0.012,64,False,vs_right,w,2624,226,94,132,2462,2340,122,0.415929203539823
8040,0.1,True,0.012,64,False,vs_left,w,2624,235,103,132,2453,2340,113,0.43829787234042555
8040,0.1,True,0.012,64,False,difference,w,2624,1,0,1,2687,2471,216,0.0
8040,0.1,True,0.012,31,True,baseline,w,328,0,0,0,336,240,96,0.0
8040,0.1,True,0.012,31,True,vs_right,w,328,52,45,7,284,233,51,0.8653846153846154
8040,0.1,True,0.012,31,True,vs_left,w,328,52,51,1,284,239,45,0.9807692307692307
8040,0.1,True,0.012,31,True,difference,w,328,2,2,0,334,240,94,1.0
8040,0.1,True,0.012,31,False,baseline,w,1271,2,0,2,1300,1204,96,0.0
8040,0.1,True,0.012,31,False,vs_right,w,1271,109,40,69,1193,1137,56,0.3669724770642202
8040,0.1,True,0.012,31,False,vs_left,w,1271,125,47,78,1177,1128,49,0.376
8040,0.1,True,0.012,31,False,difference,w,1271,0,0,0,1302,1206,96,0.0
8040,0.1,True,0.02,86,True,baseline,w,700,3,0,3,725,501,224,0.0
8040,0.1,True,0.02,86,True,vs_right,w,700,85,81,4,643,500,143,0.9529411764705882
8040,0.1,True,0.02,86,True,vs_left,w,700,89,89,0,639,504,135,1.0
8040,0.1,True,0.02,86,True,difference,w,700,0,0,0,728,504,224,0.0
8040,0.1,True,0.02,86,False,baseline,w,2150,2,0,2,2234,2010,224,0.0
8040,0.1,True,0.02,86,False,vs_right,w,2150,164,71,93,2072,1919,153,0.4329268292682927
8040,0.1,True,0.02,86,False,vs_left,w,2150,109,71,38,2127,1974,153,0.6513761467889908
8040,0.1,True,0.02,86,False,difference,w,2150,2,0,2,2234,2010,224,0.0
8040,0.1,True,0.02,64,True,baseline,w,450,2,0,2,466,322,144,0.0
8040,0.1,True,0.02,64,True,vs_right,w,450,72,67,5,396,319,77,0.9305555555555556
8040,0.1,True,0.02,64,True,vs_left,w,450,63,63,0,405,324,81,1.0
8040,0.1,True,0.02,64,True,difference,w,450,0,0,0,468,324,144,0.0
8040,0.1,True,0.02,64,False,baseline,w,1600,2,0,2,1662,1518,144,0.0
8040,0.1,True,0.02,64,False,vs_right,w,1600,121,53,68,1543,1452,91,0.4380165289256198
8040,0.1,True,0.02,64,False,vs_left,w,1600,92,54,38,1572,1482,90,0.5869565217391305
8040,0.1,True,0.02,64,False,difference,w,1600,1,0,1,1663,1519,144,0.0
8040,0.1,True,0.02,31,True,baseline,w,200,2,0,2,206,142,64,0.0
8040,0.1,True,0.02,31,True,vs_right,w,200,32,29,3,176,141,35,0.90625
8040,0.1,True,0.02,31,True,vs_left,w,200,30,30,0,178,144,34,1.0
8040,0.1,True,0.02,31,True,difference,w,200,0,0,0,208,144,64,0.0
8040,0.1,True,0.02,31,False,baseline,w,775,2,0,2,804,740,64,0.0
8040,0.1,True,0.02,31,False,vs_right,w,775,57,23,34,749,708,41,0.40350877192982454
8040,0.1,True,0.02,31,False,vs_left,w,775,61,27,34,745,708,37,0.4426229508196721
8040,0.1,True,0.02,31,False,difference,w,775,0,0,0,806,742,64,0.0
8040,0.1,True,0.004,86,True,baseline,b,3500,0,0,0,3528,2464,1064,0.0
8040,0.1,True,0.004,86,True,vs_right,b,3500,43,43,0,3485,2464,1021,1.0
8040,0.1,True,0.004,86,True,vs_left,b,3500,43,43,0,3485,2464,1021,1.0
8040,0.1,True,0.004,86,True,difference,b,3500,0,0,0,3528,2464,1064,0.0
8040,0.1,True,0.004,86,False,baseline,b,10750,0,0,0,10836,9772,1064,0.0
8040,0.1,True,0.004,86,False,vs_right,b,10750,27,2,25,10809,9747,1062,0.07407407407407407
8040,0.1,True,0.004,86,False,vs_left,b,10750,23,3,20,10813,9752,1061,0.13043478260869565
8040,0.1,True,0.004,86,False,difference,b,10750,0,0,0,10836,9772,1064,0.0
8040,0.1,True,0.004,64,True,baseline,b,2250,0,0,0,2268,1584,684,0.0
8040,0.1,True,0.004,64,True,vs_right,b,2250,44,44,0,2224,1584,640,1.0
8040,0.1,True,0.004,64,True,vs_left,b,2250,52,52,0,2216,1584,632,1.0
8040,0.1,True,0.004,64,True,difference,b,2250,0,0,0,2268,1584,684,0.0
8040,0.1,True,0.004,64,False,baseline,b,8000,0,0,0,8064,7380,684,0.0
8040,0.1,True,0.004,64,False,vs_right,b,8000,28,8,20,8036,7360,676,0.2857142857142857
8040,0.1,True,0.004,64,False,vs_left,b,8000,14,4,10,8050,7370,680,0.2857142857142857
8040,0.1,True,0.004,64,False,difference,b,8000,0,0,0,8064,7380,684,0.0
8040,0.1,True,0.004,31,True,baseline,b,1000,0,0,0,1008,704,304,0.0
8040,0.1,True,0.004,31,True,vs_right,b,1000,29,28,1,979,703,276,0.9655172413793104
8040,0.1,True,0.004,31,True,vs_left,b,1000,48,48,0,960,704,256,1.0
8040,0.1,True,0.004,31,True,difference,b,1000,0,0,0,1008,704,304,0.0
8040,0.1,True,0.004,31,False,baseline,b,3875,0,0,0,3906,3602,304,0.0
8040,0.1,True,0.004,31,False,vs_right,b,3875,21,10,11,3885,3591,294,0.47619047619047616
8040,0.1,True,0.004,31,False,vs_left,b,3875,29,17,12,3877,3590,287,0.5862068965517241
8040,0.1,True,0.004,31,False,difference,b,3875,0,0,0,3906,3602,304,0.0
8040,0.1,True,0.012,86,True,baseline,b,1148,0,0,0,1176,840,336,0.0
8040,0.1,True,0.012,86,True,vs_right,b,1148,27,27,0,1149,840,309,1.0
8040,0.1,True,0.012,86,True,vs_left,b,1148,42,42,0,1134,840,294,1.0
8040,0.1,True,0.012,86,True,difference,b,1148,0,0,0,1176,840,336,0.0
8040,0.1,True,0.012,86,False,baseline,b,3526,0,0,0,3612,3276,336,0.0
8040,0.1,True,0.012,86,False,vs_right,b,3526,32,16,16,3580,3260,320,0.5
8040,0.1,True,0.012,86,False,vs_left,b,3526,23,10,13,3589,3263,326,0.43478260869565216
8040,0.1,True,0.012,86,False,difference,b,3526,0,0,0,3612,3276,336,0.0
8040,0.1,True,0.012,64,True,baseline,b,738,0,0,0,756,540,216,0.0
8040,0.1,True,0.012,64,True,vs_right,b,738,30,29,1,726,539,187,0.9666666666666667
8040,0.1,True,0.012,64,True,vs_left,b,738,40,40,0,716,540,176,1.0
8040,0.1,True,0.012,64,True,difference,b,738,0,0,0,756,540,216,0.0
8040,0.1,True,0.012,64,False,baseline,b,2624,0,0,0,2688,2472,216,0.0
8040,0.1,True,0.012,64,False,vs_right,b,2624,25,11,14,2663,2458,205,0.44
8040,0.1,True,0.012,64,False,vs_left,b,2624,19,13,6,2669,2466,203,0.6842105263157895
8040,0.1,True,0.012,64,False,difference,b,2624,0,0,0,2688,2472,216,0.0
8040,0.1,True,0.012,31,True,baseline,b,328,0,0,0,336,240,96,0.0
8040,0.1,True,0.012,31,True,vs_right,b,328,16,15,1,320,239,81,0.9375
8040,0.1,True,0.012,31,True,vs_left,b,328,23,23,0,313,240,73,1.0
8040,0.1,True,0.012,31,True,difference,b,328,0,0,0,336,240,96,0.0
8040,0.1,True,0.012,31,False,baseline,b,1271,0,0,0,1302,1206,96,0.0
8040,0.1,True,0.012,31,False,vs_right,b,1271,18,8,10,1284,1196,88,0.4444444444444444
8040,0.1,True,0.012,31,False,vs_left,b,1271,21,15,6,1281,1200,81,0.7142857142857143
8040,0.1,True,0.012,31,False,difference,b,1271,0,0,0,1302,1206,96,0.0
8040,0.1,True,0.02,86,True,baseline,b,700,0,0,0,728,504,224,0.0
8040,0.1,True,0.02,86,True,vs_right,b,700,20,20,0,708,504,204,1.0
8040,0.1,True,0.02,86,True,vs_left,b,700,40,40,0,688,504,184,1.0
8040,0.1,True,0.02,86,True,difference,b,700,0,0,0,728,504,224,0.0
8040,0.1,True,0.02,86,False,baseline,b,2150,0,0,0,2236,2012,224,0.0
8040,0.1,True,0.02,86,False,vs_right,b,2150,27,15,12,2209,2000,209,0.5555555555555556
8040,0.1,True,0.02,86,False,vs_left,b,2150,33,23,10,2203,2002,201,0.696969696969697
8040,0.1,True,0.02,86,False,difference,b,2150,0,0,0,2236,2012,224,0.0
8040,0.1,True,0.02,64,True,baseline,b,450,0,0,0,468,324,144,0.0
8040,0.1,True,0.02,64,True,vs_right,b,450,17,17,0,451,324,127,1.0
8040,0.1,True,0.02,64,True,vs_left,b,450,31,31,0,437,324,113,1.0
8040,0.1,True,0.02,64,True,difference,b,450,0,0,0,468,324,144,0.0
8040,0.1,True,0.02,64,False,baseline,b,1600,0,0,0,1664,1520,144,0.0
8040,0.1,True,0.02,64,False,vs_right,b,1600,22,11,11,1642,1509,133,0.5
8040,0.1,True,0.02,64,False,vs_left,b,1600,28,20,8,1636,1512,124,0.7142857142857143
8040,0.1,True,0.02,64,False,difference,b,1600,0,0,0,1664,1520,144,0.0
8040,0.1,True,0.02,31,True,baseline,b,200,0,0,0,208,144,64,0.0
8040,0.1,True,0.02,31,True,vs_right,b,200,9,9,0,199,144,55,1.0
8040,0.1,True,0.02,31,True,vs_left,b,200,14,14,0,194,144,50,1.0
8040,0.1,True,0.02,31,True,difference,b,200,0,0,0,208,144,64,0.0
8040,0.1,True,0.02,31,False,baseline,b,775,0,0,0,806,742,64,0.0
8040,0.1,True,0.02,31,False,vs_right,b,775,15,6,9,791,733,58,0.4
8040,0.1,True,0.02,31,False,vs_left,b,775,17,12,5,789,737,52,0.7058823529411765
8040,0.1,True,0.02,31,False,difference,b,775,0,0,0,806,742,64,0.0
8040,0.1,False,0.004,86,True,baseline,w,3500,13,0,13,3515,2451,1064,0.0
8040,0.1,False,0.004,86,True,vs_right,w,3500,443,420,23,3085,2441,644,0.9480812641083521
8040,0.1,False,0.004,86,True,vs_left,w,3500,429,418,11,3099,2453,646,0.9743589743589743
8040,0.1,False,0.004,86,True,difference,w,3500,15,9,6,3513,2458,1055,0.6
8040,0.1,False,0.004,86,False,baseline,w,10750,16,0,16,10820,9756,1064,0.0
8040,0.1,False,0.004,86,False,vs_right,w,10750,776,384,392,10060,9380,680,0.4948453608247423
8040,0.1,False,0.004,86,False,vs_left,w,10750,775,373,402,10061,9370,691,0.48129032258064514
8040,0.1,False,0.004,86,False,difference,w,10750,14,4,10,10822,9762,1060,0.2857142857142857
8040,0.1,False,0.004,64,True,baseline,w,2250,15,0,15,2253,1569,684,0.0
8040,0.1,False,0.004,64,True,vs_right,w,2250,323,306,17,1945,1567,378,0.9473684210526315
8040,0.1,False,0.004,64,True,vs_left,w,2250,319,308,11,1949,1573,376,0.9655172413793104
8040,0.1,False,0.004,64,True,difference,w,2250,14,10,4,2254,1580,674,0.7142857142857143
8040,0.1,False,0.004,64,False,baseline,w,8000,8,0,8,8056,7372,684,0.0
8040,0.1,False,0.004,64,False,vs_right,w,8000,573,274,299,7491,7081,410,0.4781849912739965
8040,0.1,False,0.004,64,False,vs_left,w,8000,616,278,338,7448,7042,406,0.4512987012987013
8040,0.1,False,0.004,64,False,difference,w,8000,14,4,10,8050,7370,680,0.2857142857142857
8040,0.1,False,0.004,31,True,baseline,w,1000,4,0,4,1004,700,304,0.0
8040,0.1,False,0.004,31,True,vs_right,w,1000,159,144,15,849,689,160,0.9056603773584906
8040,0.1,False,0.004,31,True,vs_left,w,1000,144,132,12,864,692,172,0.9166666666666666
8040,0.1,False,0.004,31,True,difference,w,1000,12,12,0,996,704,292,1.0
8040,0.1,False,0.004,31,False,baseline,w,3875,4,0,4,3902,3598,304,0.0
8040,0.1,False,0.004,31,False,vs_right,w,3875,303,129,174,3603,3428,175,0.42574257425742573
8040,0.1,False,0.004,31,False,vs_left,w,3875,327,116,211,3579,3391,188,0.3547400611620795
8040,0.1,False,0.004,31,False,difference,w,3875,14,6,8,3892,3594,298,0.42857142857142855
8040,0.1,False,0.012,86,True,baseline,w,1148,5,0,5,1171,835,336,0.0
8040,0.1,False,0.012,86,True,vs_right,w,1148,159,150,9,1017,831,186,0.9433962264150944
8040,0.1,False,0.012,86,True,vs_left,w,1148,150,150,0,1026,840,186,1.0
8040,0.1,False,0.012,86,True,difference,w,1148,2,2,0,1174,840,334,1.0
8040,0.1,False,0.012,86,False,baseline,w,3526,3,0,3,3609,3273,336,0.0
8040,0.1,False,0.012,86,False,vs_right,w,3526,279,139,140,3333,3136,197,0.4982078853046595
8040,0.1,False,0.012,86,False,vs_left,w,3526,272,133,139,3340,3137,203,0.4889705882352941
8040,0.1,False,0.012,86,False,difference,w,3526,0,0,0,3612,3276,336,0.0
8040,0.1,False,0.012,64,True,baseline,w,738,5,0,5,751,535,216,0.0
8040,0.1,False,0.012,64,True,vs_right,w,738,118,110,8,638,532,106,0.9322033898305084
8040,0.1,False,0.012,64,True,vs_left,w,738,111,111,0,645,540,105,1.0
8040,0.1,False,0.012,64,True,difference,w,738,2,2,0,754,540,214,1.0
8040,0.1,False,0.012,64,False,baseline,w,2624,3,0,3,2685,2469,216,0.0
8040,0.1,False,0.012,64,False,vs_right,w,2624,210,98,112,2478,2360,118,0.4666666666666667
8040,0.1,False,0.012,64,False,vs_left,w,2624,212,97,115,2476,2357,119,0.45754716981132076
8040,0.1,False,0.012,64,False,difference,w,2624,0,0,0,2688,2472,216,0.0
8040,0.1,False,0.012,31,True,baseline,w,328,2,0,2,334,238,96,0.0
8040,0.1,False,0.012,31,True,vs_right,w,328,50,46,4,286,236,50,0.92
8040,0.1,False,0.012,31,True,vs_left,w,328,51,51,0,285,240,45,1.0
8040,0.1,False,0.012,31,True,difference,w,328,6,6,0,330,240,90,1.0
8040,0.1,False,0.012,31,False,baseline,w,1271,0,0,0,1302,1206,96,0.0
8040,0.1,False,0.012,31,False,vs_right,w,1271,103,45,58,1199,1148,51,0.4368932038834951
8040,0.1,False,0.012,31,False,vs_left,w,1271,111,46,65,1191,1141,50,0.4144144144144144
8040,0.1,False,0.012,31,False,difference,w,1271,2,2,0,1300,1206,94,1.0
8040,0.1,False,0.02,86,True,baseline,w,700,2,1,1,726,503,223,0.5
8040,0.1,False,0.02,86,True,vs_right,w,700,99,95,4,629,500,129,0.9595959595959596
8040,0.1,False,0.02,86,True,vs_left,w,700,71,71,0,657,504,153,1.0
8040,0.1,False,0.02,86,True,difference,w,700,0,0,0,728,504,224,0.0
8040,0.1,False,0.02,86,False,baseline,w,2150,3,0,3,2233,2009,224,0.0
8040,0.1,False,0.02,86,False,vs_right,w,2150,158,81,77,2078,1935,143,0.5126582278481012
8040,0.1,False,0.02,86,False,vs_left,w,2150,110,57,53,2126,1959,167,0.5181818181818182
8040,0.1,False,0.02,86,False,difference,w,2150,0,0,0,2236,2012,224,0.0
8040,0.1,False,0.02,64,True,baseline,w,450,2,1,1,466,323,143,0.5
8040,0.1,False,0.02,64,True,vs_right,w,450,70,65,5,398,319,79,0.9285714285714286
8040,0.1,False,0.02,64,True,vs_left,w,450,56,56,0,412,324,88,1.0
8040,0.1,False,0.02,64,True,difference,w,450,0,0,0,468,324,144,0.0
8040,0.1,False,0.02,64,False,baseline,w,1600,3,0,3,1661,1517,144,0.0
8040,0.1,False,0.02,64,False,vs_right,w,1600,113,57,56,1551,1464,87,0.504424778761062
8040,0.1,False,0.02,64,False,vs_left,w,1600,91,43,48,1573,1472,101,0.4725274725274725
8040,0.1,False,0.02,64,False,difference,w,1600,0,0,0,1664,1520,144,0.0
8040,0.1,False,0.02,31,True,baseline,w,200,2,0,2,206,142,64,0.0
8040,0.1,False,0.02,31,True,vs_right,w,200,29,29,0,179,144,35,1.0
8040,0.1,False,0.02,31,True,vs_left,w,200,29,29,0,179,144,35,1.0
8040,0.1,False,0.02,31,True,difference,w,200,0,0,0,208,144,64,0.0
8040,0.1,False,0.02,31,False,baseline,w,775,0,0,0,806,742,64,0.0
8040,0.1,False,0.02,31,False,vs_right,w,775,58,27,31,748,711,37,0.46551724137931033
8040,0.1,False,0.02,31,False,vs_left,w,775,50,16,34,756,708,48,0.32
8040,0.1,False,0.02,31,False,difference,w,775,0,0,0,806,742,64,0.0
8040,0.1,False,0.004,86,True,baseline,b,3500,0,0,0,3528,2464,1064,0.0
8040,0.1,False,0.004,86,True,vs_right,b,3500,59,58,1,3469,2463,1006,0.9830508474576272
8040,0.1,False,0.004,86,True,vs_left,b,3500,38,38,0,3490,2464,1026,1.0
8040,0.1,False,0.004,86,True,difference,b,3500,0,0,0,3528,2464,1064,0.0
8040,0.1,False,0.004,86,False,baseline,b,10750,0,0,0,10836,9772,1064,0.0
8040,0.1,False,0.004,86,False,vs_right,b,10750,33,17,16,10803,9756,1047,0.5151515151515151
8040,0.1,False,0.004,86,False,vs_left,b,10750,9,6,3,10827,9769,1058,0.6666666666666666
8040,0.1,False,0.004,86,False,difference,b,10750,1,0,1,10835,9771,1064,0.0
8040,0.1,False,0.004,64,True,baseline,b,2250,0,0,0,2268,1584,684,0.0
8040,0.1,False,0.004,64,True,vs_right,b,2250,51,51,0,2217,1584,633,1.0
8040,0.1,False,0.004,64,True,vs_left,b,2250,45,45,0,2223,1584,639,1.0
8040,0.1,False,0.004,64,True,difference,b,2250,0,0,0,2268,1584,684,0.0
8040,0.1,False,0.004,64,False,baseline,b,8000,0,0,0,8064,7380,684,0.0
8040,0.1,False,0.004,64,False,vs_right,b,8000,31,19,12,8033,7368,665,0.6129032258064516
8040,0.1,False,0.004,64,False,vs_left,b,8000,12,6,6,8052,7374,678,0.5
8040,0.1,False,0.004,64,False,difference,b,8000,1,0,1,8063,7379,684,0.0
8040,0.1,False,0.004,31,True,baseline,b,1000,0,0,0,1008,704,304,0.0
8040,0.1,False,0.004,31,True,vs_right,b,1000,32,32,0,976,704,272,1.0
8040,0.1,False,0.004,31,True,vs_left,b,1000,33,33,0,975,704,271,1.0
8040,0.1,False,0.004,31,True,difference,b,1000,0,0,0,1008,704,304,0.0
8040,0.1,False,0.004,31,False,baseline,b,3875,0,0,0,3906,3602,304,0.0
8040,0.1,False,0.004,31,False,vs_right,b,3875,27,19,8,3879,3594,285,0.7037037037037037
8040,0.1,False,0.004,31,False,vs_left,b,3875,20,12,8,3886,3594,292,0.6
8040,0.1,False,0.004,31,False,difference,b,3875,1,0,1,3905,3601,304,0.0
8040,0.1,False,0.012,86,True,baseline,b,1148,0,0,0,1176,840,336,0.0
8040,0.1,False,0.012,86,True,vs_right,b,1148,31,30,1,1145,839,306,0.967741935483871
8040,0.1,False,0.012,86,True,vs_left,b,1148,35,35,0,1141,840,301,1.0
8040,0.1,False,0.012,86,True,difference,b,1148,0,0,0,1176,840,336,0.0
8040,0.1,False,0.012,86,False,baseline,b,3526,0,0,0,3612,3276,336,0.0
8040,0.1,False,0.012,86,False,vs_right,b,3526,28,17,11,3584,3265,319,0.6071428571428571
8040,0.1,False,0.012,86,False,vs_left,b,3526,12,7,5,3600,3271,329,0.5833333333333334
8040,0.1,False,0.012,86,False,difference,b,3526,1,0,1,3611,3275,336,0.0
8040,0.1,False,0.012,64,True,baseline,b,738,0,0,0,756,540,216,0.0
8040,0.1,False,0.012,64,True,vs_right,b,738,27,27,0,729,540,189,1.0
8040,0.1,False,0.012,64,True,vs_left,b,738,34,34,0,722,540,182,1.0
8040,0.1,False,0.012,64,True,difference,b,738,0,0,0,756,540,216,0.0
8040,0.1,False,0.012,64,False,baseline,b,2624,0,0,0,2688,2472,216,0.0
8040,0.1,False,0.012,64,False,vs_right,b,2624,22,13,9,2666,2463,203,0.5909090909090909
8040,0.1,False,0.012,64,False,vs_left,b,2624,19,10,9,2669,2463,206,0.5263157894736842
8040,0.1,False,0.012,64,False,difference,b,2624,1,0,1,2687,2471,216,0.0
8040,0.1,False,0.012,31,True,baseline,b,328,0,0,0,336,240,96,0.0
8040,0.1,False,0.012,31,True,vs_right,b,328,17,17,0,319,240,79,1.0
8040,0.1,False,0.012,31,True,vs_left,b,328,17,17,0,319,240,79,1.0
8040,0.1,False,0.012,31,True,difference,b,328,0,0,0,336,240,96,0.0
8040,0.1,False,0.012,31,False,baseline,b,1271,0,0,0,1302,1206,96,0.0
8040,0.1,False,0.012,31,False,vs_right,b,1271,16,10,6,1286,1200,86,0.625
8040,0.1,False,0.012,31,False,vs_left,b,1271,21,10,11,1281,1195,86,0.47619047619047616
8040,0.1,False,0.012,31,False,difference,b,1271,1,0,1,1301,1205,96,0.0
8040,0.1,False,0.02,86,True,baseline,b,700,0,0,0,728,504,224,0.0
8040,0.1,False,0.02,86,True,vs_right,b,700,25,25,0,703,504,199,1.0
8040,0.1,False,0.02,86,True,vs_left,b,700,31,31,0,697,504,193,1.0
8040,0.1,False,0.02,86,True,difference,b,700,0,0,0,728,504,224,0.0
8040,0.1,False,0.02,86,False,baseline,b,2150,0,0,0,2236,2012,224,0.0
8040,0.1,False,0.02,86,False,vs_right,b,2150,22,14,8,2214,2004,210,0.6363636363636364
8040,0.1,False,0.02,86,False,vs_left,b,2150,28,18,10,2208,2002,206,0.6428571428571429
8040,0.1,False,0.02,86,False,difference,b,2150,0,0,0,2236,2012,224,0.0
8040,0.1,False,0.02,64,True,baseline,b,450,0,0,0,468,324,144,0.0
8040,0.1,False,0.02,64,True,vs_right,b,450,21,21,0,447,324,123,1.0
8040,0.1,False,0.02,64,True,vs_left,b,450,26,26,0,442,324,118,1.0
8040,0.1,False,0.02,64,True,difference,b,450,0,0,0,468,324,144,0.0
8040,0.1,False,0.02,64,False,baseline,b,1600,0,0,0,1664,1520,144,0.0
8040,0.1,False,0.02,64,False,vs_right,b,1600,18,10,8,1646,1512,134,0.5555555555555556
8040,0.1,False,0.02,64,False,vs_left,b,1600,25,17,8,1639,1512,127,0.68
8040,0.1,False,0.02,64,False,difference,b,1600,0,0,0,1664,1520,144,0.0
8040,0.1,False,0.02,31,True,baseline,b,200,0,0,0,208,144,64,0.0
8040,0.1,False,0.02,31,True,vs_right,b,200,12,12,0,196,144,52,1.0
8040,0.1,False,0.02,31,True,vs_left,b,200,11,11,0,197,144,53,1.0
8040,0.1,False,0.02,31,True,difference,b,200,0,0,0,208,144,64,0.0
8040,0.1,False,0.02,31,False,baseline,b,775,0,0,0,806,742,64,0.0
8040,0.1,False,0.02,31,False,vs_right,b,775,12,7,5,794,737,57,0.5833333333333334
8040,0.1,False,0.02,31,False,vs_left,b,775,19,10,9,787,733,54,0.5263157894736842
8040,0.1,False,0.02,31,False,difference,b,775,0,0,0,806,742,64,0.0
8040,0.2,True,0.004,86,True,baseline,w,3500,13,7,6,3515,2458,1057,0.5384615384615384
8040,0.2,True,0.004,86,True,vs_right,w,3500,556,495,61,2972,2403,569,0.8902877697841727
8040,0.2,True,0.004,86,True,vs_left,w,3500,504,480,24,3024,2440,584,0.9523809523809523
8040,0.2,True,0.004,86,True,difference,w,3500,35,26,9,3493,2455,1038,0.7428571428571429
8040,0.2,True,0.004,86,False,baseline,w,10750,16,6,10,10820,9762,1058,0.375
8040,0.2,True,0.004,86,False,vs_right,w,10750,1269,451,818,9567,8954,613,0.355397951142632
8040,0.2,True,0.004,86,False,vs_left,w,10750,1280,437,843,9556,8929,627,0.34140625
8040,0.2,True,0.004,86,False,difference,w,10750,43,20,23,10793,9749,1044,0.46511627906976744
8040,0.2,True,0.004,64,True,baseline,w,2250,8,0,8,2260,1576,684,0.0
8040,0.2,True,0.004,64,True,vs_right,w,2250,390,347,43,1878,1541,337,0.8897435897435897
8040,0.2,True,0.004,64,True,vs_left,w,2250,369,346,23,1899,1561,338,0.9376693766937669
8040,0.2,True,0.004,64,True,difference,w,2250,9,3,6,2259,1578,681,0.3333333333333333
8040,0.2,True,0.004,64,False,baseline,w,8000,12,0,12,8052,7368,684,0.0
8040,0.2,True,0.004,64,False,vs_right,w,8000,959,318,641,7105,6739,366,0.3315954118873827
8040,0.2,True,0.004,64,False,vs_left,w,8000,987,313,674,7077,6706,371,0.3171225937183384
8040,0.2,True,0.004,64,False,difference,w,8000,17,2,15,8047,7365,682,0.11764705882352941
8040,0.2,True,0.004,31,True,baseline,w,1000,8,0,8,1000,696,304,0.0
8040,0.2,True,0.004,31,True,vs_right,w,1000,179,156,23,829,681,148,0.8715083798882681
8040,0.2,True,0.004,31,True,vs_left,w,1000,168,150,18,840,686,154,0.8928571428571429
8040,0.2,True,0.004,31,True,difference,w,1000,10,6,4,998,700,298,0.6
8040,0.2,True,0.004,31,False,baseline,w,3875,6,0,6,3900,3596,304,0.0
8040,0.2,True,0.004,31,False,vs_right,w,3875,493,144,349,3413,3253,160,0.2920892494929006
8040,0.2,True,0.004,31,False,vs_left,w,3875,508,138,370,3398,3232,166,0.27165354330708663
8040,0.2,True,0.004,31,False,difference,w,3875,17,3,14,3889,3588,301,0.17647058823529413
8040,0.2,True,0.012,86,True,baseline,w,1148,0,0,0,1176,840,336,0.0
8040,0.2,True,0.012,86,True,vs_right,w,1148,190,169,21,986,819,167,0.8894736842105263
8040,0.2,True,0.012,86,True,vs_left,w,1148,175,171,4,1001,836,165,0.9771428571428571
8040,0.2,True,0.012,86,True,difference,w,1148,10,8,2,1166,838,328,0.8
8040,0.2,True,0.012,86,False,baseline,w,3526,0,0,0,3612,3276,336,0.0
8040,0.2,True,0.012,86,False,vs_right,w,3526,471,162,309,3141,2967,174,0.34394904458598724
8040,0.2,True,0.012,86,False,vs_left,w,3526,441,151,290,3171,2986,185,0.3424036281179138
8040,0.2,True,0.012,86,False,difference,w,3526,13,5,8,3599,3268,331,0.38461538461538464
8040,0.2,True,0.012,64,True,baseline,w,738,0,0,0,756,540,216,0.0
8040,0.2,True,0.012,64,True,vs_right,w,738,138,117,21,618,519,99,0.8478260869565217
8040,0.2,True,0.012,64,True,vs_left,w,738,128,126,2,628,538,90,0.984375
8040,0.2,True,0.012,64,True,difference,w,738,0,0,0,756,540,216,0.0
8040,0.2,True,0.012,64,False,baseline,w,2624,0,0,0,2688,2472,216,0.0
8040,0.2,True,0.012,64,False,vs_right,w,2624,354,111,243,2334,2229,105,0.3135593220338983
8040,0.2,True,0.012,64,False,vs_left,w,2624,339,109,230,2349,2242,107,0.3215339233038348
8040,0.2,True,0.012,64,False,difference,w,2624,4,0,4,2684,2468,216,0.0
8040,0.2,True,0.012,31,True,baseline,w,328,0,0,0,336,240,96,0.0
8040,0.2,True,0.012,31,True,vs_right,w,328,62,51,11,274,229,45,0.8225806451612904
8040,0.2,True,0.012,31,True,vs_left,w,328,56,54,2,280,238,42,0.9642857142857143
8040,0.2,True,0.012,31,True,difference,w,328,4,4,0,332,240,92,1.0
8040,0.2,True,0.012,31,False,baseline,w,1271,0,0,0,1302,1206,96,0.0
8040,0.2,True,0.012,31,False,vs_right,w,1271,171,49,122,1131,1084,47,0.28654970760233917
8040,0.2,True,0.012,31,False,vs_left,w,1271,170,46,124,1132,1082,50,0.27058823529411763
8040,0.2,True,0.012,31,False,difference,w,1271,2,0,2,1300,1204,96,0.0
8040,0.2,True,0.02,86,True,baseline,w,700,0,0,0,728,504,224,0.0
8040,0.2,True,0.02,86,True,vs_right,w,700,118,103,15,610,489,121,0.8728813559322034
8040,0.2,True,0.02,86,True,vs_left,w,700,97,95,2,631,502,129,0.979381443298969
8040,0.2,True,0.02,86,True,difference,w,700,2,2,0,726,504,222,1.0
8040,0.2,True,0.02,86,False,baseline,w,2150,0,0,0,2236,2012,224,0.0
8040,0.2,True,0.02,86,False,vs_right,w,2150,246,96,150,1990,1862,128,0.3902439024390244
8040,0.2,True,0.02,86,False,vs_left,w,2150,213,80,133,2023,1879,144,0.3755868544600939
8040,0.2,True,0.02,86,False,difference,w,2150,2,2,0,2234,2012,222,1.0
8040,0.2,True,0.02,64,True,baseline,w,450,0,0,0,468,324,144,0.0
8040,0.2,True,0.02,64,True,vs_right,w,450,82,69,13,386,311,75,0.8414634146341463
8040,0.2,True,0.02,64,True,vs_left,w,450,74,72,2,394,322,72,0.972972972972973
8040,0.2,True,0.02,64,True,difference,w,450,0,0,0,468,324,144,0.0
8040,0.2,True,0.02,64,False,baseline,w,1600,0,0,0,1664,1520,144,0.0
8040,0.2,True,0.02,64,False,vs_right,w,1600,184,66,118,1480,1402,78,0.358695652173913
8040,0.2,True,0.02,64,False,vs_left,w,1600,159,60,99,1505,1421,84,0.37735849056603776
8040,0.2,True,0.02,64,False,difference,w,1600,0,0,0,1664,1520,144,0.0
8040,0.2,True,0.02,31,True,baseline,w,200,0,0,0,208,144,64,0.0
8040,0.2,True,0.02,31,True,vs_right,w,200,35,30,5,173,139,34,0.8571428571428571
8040,0.2,True,0.02,31,True,vs_left,w,200,32,32,0,176,144,32,1.0
8040,0.2,True,0.02,31,True,difference,w,200,0,0,0,208,144,64,0.0
8040,0.2,True,0.02,31,False,baseline,w,775,0,0,0,806,742,64,0.0
8040,0.2,True,0.02,31,False,vs_right,w,775,91,29,62,715,680,35,0.31868131868131866
8040,0.2,True,0.02,31,False,vs_left,w,775,94,27,67,712,675,37,0.2872340425531915
8040,0.2,True,0.02,31,False,difference,w,775,0,0,0,806,742,64,0.0
8040,0.2,True,0.004,86,True,baseline,b,3500,0,0,0,3528,2464,1064,0.0
8040,0.2,True,0.004,86,True,vs_right,b,3500,79,79,0,3449,2464,985,1.0
8040,0.2,True,0.004,86,True,vs_left,b,3500,59,59,0,3469,2464,1005,1.0
8040,0.2,True,0.004,86,True,difference,b,3500,0,0,0,3528,2464,1064,0.0
8040,0.2,True,0.004,86,False,baseline,b,10750,0,0,0,10836,9772,1064,0.0
8040,0.2,True,0.004,86,False,vs_right,b,10750,48,25,23,10788,9749,1039,0.5208333333333334
8040,0.2,True,0.004,86,False,vs_left,b,10750,34,5,29,10802,9743,1059,0.14705882352941177
8040,0.2,True,0.004,86,False,difference,b,10750,0,0,0,10836,9772,1064,0.0
8040,0.2,True,0.004,64,True,baseline,b,2250,0,0,0,2268,1584,684,0.0
8040,0.2,True,0.004,64,True,vs_right,b,2250,72,72,0,2196,1584,612,1.0
8040,0.2,True,0.004,64,True,vs_left,b,2250,67,67,0,2201,1584,617,1.0
8040,0.2,True,0.004,64,True,difference,b,2250,0,0,0,2268,1584,684,0.0
8040,0.2,True,0.004,64,False,baseline,b,8000,0,0,0,8064,7380,684,0.0
8040,0.2,True,0.004,64,False,vs_right,b,8000,38,18,20,8026,7360,666,0.47368421052631576
8040,0.2,True,0.004,64,False,vs_left,b,8000,34,6,28,8030,7352,678,0.17647058823529413
8040,0.2,True,0.004,64,False,difference,b,8000,0,0,0,8064,7380,684,0.0
8040,0.2,True,0.004,31,True,baseline,b,1000,0,0,0,1008,704,304,0.0
8040,0.2,True,0.004,31,True,vs_right,b,1000,37,37,0,971,704,267,1.0
8040,0.2,True,0.004,31,True,vs_left,b,1000,48,48,0,960,704,256,1.0
8040,0.2,True,0.004,31,True,difference,b,1000,0,0,0,1008,704,304,0.0
8040,0.2,True,0.004,31,False,baseline,b,3875,0,0,0,3906,3602,304,0.0
8040,0.2,True,0.004,31,False,vs_right,b,3875,36,22,14,3870,3588,282,0.6111111111111112
8040,0.2,True,0.004,31,False,vs_left,b,3875,51,16,35,3855,3567,288,0.3137254901960784
8040,0.2,True,0.004,31,False,difference,b,3875,0,0,0,3906,3602,304,0.0
8040,0.2,True,0.012,86,True,baseline,b,1148,0,0,0,1176,840,336,0.0
8040,0.2,True,0.012,86,True,vs_right,b,1148,44,44,0,1132,840,292,1.0
8040,0.2,True,0.012,86,True,vs_left,b,1148,57,57,0,1119,840,279,1.0
8040,0.2,True,0.012,86,True,difference,b,1148,0,0,0,1176,840,336,0.0
8040,0.2,True,0.012,86,False,baseline,b,3526,0,0,0,3612,3276,336,0.0
8040,0.2,True,0.012,86,False,vs_right,b,3526,44,23,21,3568,3255,313,0.5227272727272727
8040,0.2,True,0.012,86,False,vs_left,b,3526,48,20,28,3564,3248,316,0.4166666666666667
8040,0.2,True,0.012,86,False,difference,b,3526,0,0,0,3612,3276,336,0.0
8040,0.2,True,0.012,64,True,baseline,b,738,0,0,0,756,540,216,0.0
8040,0.2,True,0.012,64,True,vs_right,b,738,39,39,0,717,540,177,1.0
8040,0.2,True,0.012,64,True,vs_left,b,738,51,51,0,705,540,165,1.0
8040,0.2,True,0.012,64,True,difference,b,738,0,0,0,756,540,216,0.0
8040,0.2,True,0.012,64,False,baseline,b,2624,0,0,0,2688,2472,216,0.0
8040,0.2,True,0.012,64,False,vs_right,b,2624,37,17,20,2651,2452,199,0.4594594594594595
8040,0.2,True,0.012,64,False,vs_left,b,2624,49,17,32,2639,2440,199,0.3469387755102041
8040,0.2,True,0.012,64,False,difference,b,2624,0,0,0,2688,2472,216,0.0
8040,0.2,True,0.012,31,True,baseline,b,328,0,0,0,336,240,96,0.0
8040,0.2,True,0.012,31,True,vs_right,b,328,21,21,0,315,240,75,1.0
8040,0.2,True,0.012,31,True,vs_left,b,328,24,24,0,312,240,72,1.0
8040,0.2,True,0.012,31,True,difference,b,328,0,0,0,336,240,96,0.0
8040,0.2,True,0.012,31,False,baseline,b,1271,0,0,0,1302,1206,96,0.0
8040,0.2,True,0.012,31,False,vs_right,b,1271,24,10,14,1278,1192,86,0.4166666666666667
8040,0.2,True,0.012,31,False,vs_left,b,1271,46,15,31,1256,1175,81,0.32608695652173914
8040,0.2,True,0.012,31,False,difference,b,1271,0,0,0,1302,1206,96,0.0
8040,0.2,True,0.02,86,True,baseline,b,700,0,0,0,728,504,224,0.0
8040,0.2,True,0.02,86,True,vs_right,b,700,29,29,0,699,504,195,1.0
8040,0.2,True,0.02,86,True,vs_left,b,700,46,46,0,682,504,178,1.0
8040,0.2,True,0.02,86,True,difference,b,700,0,0,0,728,504,224,0.0
8040,0.2,True,0.02,86,False,baseline,b,2150,0,0,0,2236,2012,224,0.0
8040,0.2,True,0.02,86,False,vs_right,b,2150,44,22,22,2192,1990,202,0.5
8040,0.2,True,0.02,86,False,vs_left,b,2150,60,33,27,2176,1985,191,0.55
8040,0.2,True,0.02,86,False,difference,b,2150,0,0,0,2236,2012,224,0.0
8040,0.2,True,0.02,64,True,baseline,b,450,0,0,0,468,324,144,0.0
8040,0.2,True,0.02,64,True,vs_right,b,450,25,25,0,443,324,119,1.0
8040,0.2,True,0.02,64,True,vs_left,b,450,34,34,0,434,324,110,1.0
8040,0.2,True,0.02,64,True,difference,b,450,0,0,0,468,324,144,0.0
8040,0.2,True,0.02,64,False,baseline,b,1600,0,0,0,1664,1520,144,0.0
8040,0.2,True,0.02,64,False,vs_right,b,1600,42,17,25,1622,1495,127,0.40476190476190477
8040,0.2,True,0.02,64,False,vs_left,b,1600,56,29,27,1608,1493,115,0.5178571428571429
8040,0.2,True,0.02,64,False,difference,b,1600,0,0,0,1664,1520,144,0.0
8040,0.2,True,0.02,31,True,baseline,b,200,0,0,0,208,144,64,0.0
8040,0.2,True,0.02,31,True,vs_right,b,200,15,15,0,193,144,49,1.0
8040,0.2,True,0.02,31,True,vs_left,b,200,15,14,1,193,143,50,0.9333333333333333
8040,0.2,True,0.02,31,True,difference,b,200,0,0,0,208,144,64,0.0
8040,0.2,True,0.02,31,False,baseline,b,775,0,0,0,806,742,64,0.0
8040,0.2,True,0.02,31,False,vs_right,b,775,23,8,15,783,727,56,0.34782608695652173
8040,0.2,True,0.02,31,False,vs_left,b,775,38,14,24,768,718,50,0.3684210526315789
8040,0.2,True,0.02,31,False,difference,b,775,0,0,0,806,742,64,0.0
8040,0.2,False,0.004,86,True,baseline,w,3500,15,5,10,3513,2454,1059,0.3333333333333333
8040,0.2,False,0.004,86,True,vs_right,w,3500,549,481,68,2979,2396,583,0.8761384335154827
8040,0.2,False,0.004,86,True,vs_left,w,3500,510,487,23,3018,2441,577,0.9549019607843138
8040,0.2,False,0.004,86,True,difference,w,3500,29,17,12,3499,2452,1047,0.5862068965517241
8040,0.2,False,0.004,86,False,baseline,w,10750,8,2,6,10828,9766,1062,0.25
8040,0.2,False,0.004,86,False,vs_right,w,10750,1276,430,846,9560,8926,634,0.33699059561128525
8040,0.2,False,0.004,86,False,vs_left,w,10750,1233,437,796,9603,8976,627,0.3544201135442011
8040,0.2,False,0.004,86,False,difference,w,10750,29,9,20,10807,9752,1055,0.3103448275862069
8040,0.2,False,0.004,64,True,baseline,w,2250,10,2,8,2258,1576,682,0.2
8040,0.2,False,0.004,64,True,vs_right,w,2250,417,354,63,1851,1521,330,0.8489208633093526
8040,0.2,False,0.004,64,True,vs_left,w,2250,371,351,20,1897,1564,333,0.9460916442048517
8040,0.2,False,0.004,64,True,difference,w,2250,21,12,9,2247,1575,672,0.5714285714285714
8040,0.2,False,0.004,64,False,baseline,w,8000,6,0,6,8058,7374,684,0.0
8040,0.2,False,0.004,64,False,vs_right,w,8000,972,305,667,7092,6713,379,0.31378600823045266
8040,0.2,False,0.004,64,False,vs_left,w,8000,962,320,642,7102,6738,364,0.33264033264033266
8040,0.2,False,0.004,64,False,difference,w,8000,20,4,16,8044,7364,680,0.2
8040,0.2,False,0.004,31,True,baseline,w,1000,2,0,2,1006,702,304,0.0
8040,0.2,False,0.004,31,True,vs_right,w,1000,190,151,39,818,665,153,0.7947368421052632
8040,0.2,False,0.004,31,True,vs_left,w,1000,164,150,14,844,690,154,0.9146341463414634
8040,0.2,False,0.004,31,True,difference,w,1000,15,7,8,993,696,297,0.4666666666666667
8040,0.2,False,0.004,31,False,baseline,w,3875,2,0,2,3904,3600,304,0.0
8040,0.2,False,0.004,31,False,vs_right,w,3875,506,137,369,3400,3233,167,0.2707509881422925
8040,0.2,False,0.004,31,False,vs_left,w,3875,475,138,337,3431,3265,166,0.2905263157894737
8040,0.2,False,0.004,31,False,difference,w,3875,13,2,11,3893,3591,302,0.15384615384615385
8040,0.2,False,0.012,86,True,baseline,w,1148,0,0,0,1176,840,336,0.0
8040,0.2,False,0.012,86,True,vs_right,w,1148,202,168,34,974,806,168,0.8316831683168316
8040,0.2,False,0.012,86,True,vs_left,w,1148,183,179,4,993,836,157,0.9781420765027322
8040,0.2,False,0.012,86,True,difference,w,1148,8,4,4,1168,836,332,0.5
8040,0.2,False,0.012,86,False,baseline,w,3526,0,0,0,3612,3276,336,0.0
8040,0.2,False,0.012,86,False,vs_right,w,3526,466,156,310,3146,2966,180,0.33476394849785407
8040,0.2,False,0.012,86,False,vs_left,w,3526,436,157,279,3176,2997,179,0.36009174311926606
8040,0.2,False,0.012,86,False,difference,w,3526,7,2,5,3605,3271,334,0.2857142857142857
8040,0.2,False,0.012,64,True,baseline,w,738,0,0,0,756,540,216,0.0
8040,0.2,False,0.012,64,True,vs_right,w,738,147,119,28,609,512,97,0.8095238095238095
8040,0.2,False,0.012,64,True,vs_left,w,738,135,131,4,621,536,85,0.9703703703703703
8040,0.2,False,0.012,64,True,difference,w,738,8,2,6,748,534,214,0.25
8040,0.2,False,0.012,64,False,baseline,w,2624,0,0,0,2688,2472,216,0.0
8040,0.2,False,0.012,64,False,vs_right,w,2624,363,115,248,2325,2224,101,0.3168044077134986
8040,0.2,False,0.012,64,False,vs_left,w,2624,342,116,226,2346,2246,100,0.3391812865497076
8040,0.2,False,0.012,64,False,difference,w,2624,5,0,5,2683,2467,216,0.0
8040,0.2,False,0.012,31,True,baseline,w,328,0,0,0,336,240,96,0.0
8040,0.2,False,0.012,31,True,vs_right,w,328,64,49,15,272,225,47,0.765625
8040,0.2,False,0.012,31,True,vs_left,w,328,57,55,2,279,238,41,0.9649122807017544
8040,0.2,False,0.012,31,True,difference,w,328,4,2,2,332,238,94,0.5
8040,0.2,False,0.012,31,False,baseline,w,1271,0,0,0,1302,1206,96,0.0
8040,0.2,False,0.012,31,False,vs_right,w,1271,183,49,134,1119,1072,47,0.2677595628415301
8040,0.2,False,0.012,31,False,vs_left,w,1271,166,50,116,1136,1090,46,0.30120481927710846
8040,0.2,False,0.012,31,False,difference,w,1271,4,2,2,1298,1204,94,0.5
8040,0.2,False,0.02,86,True,baseline,w,700,0,0,0,728,504,224,0.0
8040,0.2,False,0.02,86,True,vs_right,w,700,123,101,22,605,482,123,0.8211382113821138
8040,0.2,False,0.02,86,True,vs_left,w,700,102,102,0,626,504,122,1.0
8040,0.2,False,0.02,86,True,difference,w,700,0,0,0,728,504,224,0.0
8040,0.2,False,0.02,86,False,baseline,w,2150,0,0,0,2236,2012,224,0.0
8040,0.2,False,0.02,86,False,vs_right,w,2150,263,93,170,1973,1842,131,0.35361216730038025
8040,0.2,False,0.02,86,False,vs_left,w,2150,196,88,108,2040,1904,136,0.4489795918367347
8040,0.2,False,0.02,86,False,difference,w,2150,1,0,1,2235,2011,224,0.0
8040,0.2,False,0.02,64,True,baseline,w,450,0,0,0,468,324,144,0.0
8040,0.2,False,0.02,64,True,vs_right,w,450,88,70,18,380,306,74,0.7954545454545454
8040,0.2,False,0.02,64,True,vs_left,w,450,72,72,0,396,324,72,1.0
8040,0.2,False,0.02,64,True,difference,w,450,0,0,0,468,324,144,0.0
8040,0.2,False,0.02,64,False,baseline,w,1600,0,0,0,1664,1520,144,0.0
8040,0.2,False,0.02,64,False,vs_right,w,1600,204,67,137,1460,1383,77,0.3284313725490196
8040,0.2,False,0.02,64,False,vs_left,w,1600,158,65,93,1506,1427,79,0.41139240506329117
8040,0.2,False,0.02,64,False,difference,w,1600,3,0,3,1661,1517,144,0.0
8040,0.2,False,0.02,31,True,baseline,w,200,0,0,0,208,144,64,0.0
8040,0.2,False,0.02,31,True,vs_right,w,200,38,30,8,170,136,34,0.7894736842105263
8040,0.2,False,0.02,31,True,vs_left,w,200,36,34,2,172,142,30,0.9444444444444444
8040,0.2,False,0.02,31,True,difference,w,200,0,0,0,208,144,64,0.0
8040,0.2,False,0.02,31,False,baseline,w,775,0,0,0,806,742,64,0.0
8040,0.2,False,0.02,31,False,vs_right,w,775,106,29,77,700,665,35,0.27358490566037735
8040,0.2,False,0.02,31,False,vs_left,w,775,86,31,55,720,687,33,0.36046511627906974
8040,0.2,False,0.02,31,False,difference,w,775,0,0,0,806,742,64,0.0
8040,0.2,False,0.004,86,True,baseline,b,3500,0,0,0,3528,2464,1064,0.0
8040,0.2,False,0.004,86,True,vs_right,b,3500,65,65,0,3463,2464,999,1.0
8040,0.2,False,0.004,86,True,vs_left,b,3500,69,69,0,3459,2464,995,1.0
8040,0.2,False,0.004,86,True,difference,b,3500,0,0,0,3528,2464,1064,0.0
8040,0.2,False,0.004,86,False,baseline,b,10750,0,0,0,10836,9772,1064,0.0
8040,0.2,False,0.004,86,False,vs_right,b,10750,48,13,35,10788,9737,1051,0.2708333333333333
8040,0.2,False,0.004,86,False,vs_left,b,10750,40,9,31,10796,9741,1055,0.225
8040,0.2,False,0.004,86,False,difference,b,10750,0,0,0,10836,9772,1064,0.0
8040,0.2,False,0.004,64,True,baseline,b,2250,0,0,0,2268,1584,684,0.0
8040,0.2,False,0.004,64,True,vs_right,b,2250,60,60,0,2208,1584,624,1.0
8040,0.2,False,0.004,64,True,vs_left,b,2250,77,77,0,2191,1584,607,1.0
8040,0.2,False,0.004,64,True,difference,b,2250,0,0,0,2268,1584,684,0.0
8040,0.2,False,0.004,64,False,baseline,b,8000,0,0,0,8064,7380,684,0.0
8040,0.2,False,0.004,64,False,vs_right,b,8000,38,10,28,8026,7352,674,0.2631578947368421
8040,0.2,False,0.004,64,False,vs_left,b,8000,43,9,34,8021,7346,675,0.20930232558139536
8040,0.2,False,0.004,64,False,difference,b,8000,0,0,0,8064,7380,684,0.0
8040,0.2,False,0.004,31,True,baseline,b,1000,0,0,0,1008,704,304,0.0
8040,0.2,False,0.004,31,True,vs_right,b,1000,38,38,0,970,704,266,1.0
8040,0.2,False,0.004,31,True,vs_left,b,1000,47,47,0,961,704,257,1.0
8040,0.2,False,0.004,31,True,difference,b,1000,1,0,1,1007,703,304,0.0
8040,0.2,False,0.004,31,False,baseline,b,3875,0,0,0,3906,3602,304,0.0
8040,0.2,False,0.004,31,False,vs_right,b,3875,54,16,38,3852,3564,288,0.2962962962962963
8040,0.2,False,0.004,31,False,vs_left,b,3875,39,15,24,3867,3578,289,0.38461538461538464
8040,0.2,False,0.004,31,False,difference,b,3875,0,0,0,3906,3602,304,0.0
8040,0.2,False,0.012,86,True,baseline,b,1148,0,0,0,1176,840,336,0.0
8040,0.2,False,0.012,86,True,vs_right,b,1148,38,37,1,1138,839,299,0.9736842105263158
8040,0.2,False,0.012,86,True,vs_left,b,1148,58,58,0,1118,840,278,1.0
8040,0.2,False,0.012,86,True,difference,b,1148,0,0,0,1176,840,336,0.0
8040,0.2,False,0.012,86,False,baseline,b,3526,0,0,0,3612,3276,336,0.0
8040,0.2,False,0.012,86,False,vs_right,b,3526,47,20,27,3565,3249,316,0.425531914893617
8040,0.2,False,0.012,86,False,vs_left,b,3526,48,22,26,3564,3250,314,0.4583333333333333
8040,0.2,False,0.012,86,False,difference,b,3526,0,0,0,3612,3276,336,0.0
8040,0.2,False,0.012,64,True,baseline,b,738,0,0,0,756,540,216,0.0
8040,0.2,False,0.012,64,True,vs_right,b,738,35,34,1,721,539,182,0.9714285714285714
8040,0.2,False,0.012,64,True,vs_left,b,738,52,52,0,704,540,164,1.0
8040,0.2,False,0.012,64,True,difference,b,738,0,0,0,756,540,216,0.0
8040,0.2,False,0.012,64,False,baseline,b,2624,0,0,0,2688,2472,216,0.0
8040,0.2,False,0.012,64,False,vs_right,b,2624,42,17,25,2646,2447,199,0.40476190476190477
8040,0.2,False,0.012,64,False,vs_left,b,2624,48,23,25,2640,2447,193,0.4791666666666667
8040,0.2,False,0.012,64,False,difference,b,2624,0,0,0,2688,2472,216,0.0
8040,0.2,False,0.012,31,True,baseline,b,328,0,0,0,336,240,96,0.0
8040,0.2,False,0.012,31,True,vs_right,b,328,18,18,0,318,240,78,1.0
8040,0.2,False,0.012,31,True,vs_left,b,328,26,26,0,310,240,70,1.0
8040,0.2,False,0.012,31,True,difference,b,328,0,0,0,336,240,96,0.0
8040,0.2,False,0.012,31,False,baseline,b,1271,0,0,0,1302,1206,96,0.0
8040,0.2,False,0.012,31,False,vs_right,b,1271,29,9,20,1273,1186,87,0.3103448275862069
8040,0.2,False,0.012,31,False,vs_left,b,1271,37,16,21,1265,1185,80,0.43243243243243246
8040,0.2,False,0.012,31,False,difference,b,1271,0,0,0,1302,1206,96,0.0
8040,0.2,False,0.02,86,True,baseline,b,700,0,0,0,728,504,224,0.0
8040,0.2,False,0.02,86,True,vs_right,b,700,23,22,1,705,503,202,0.9565217391304348
8040,0.2,False,0.02,86,True,vs_left,b,700,45,45,0,683,504,179,1.0
8040,0.2,False,0.02,86,True,difference,b,700,0,0,0,728,504,224,0.0
8040,0.2,False,0.02,86,False,baseline,b,2150,0,0,0,2236,2012,224,0.0
8040,0.2,False,0.02,86,False,vs_right,b,2150,50,19,31,2186,1981,205,0.38
8040,0.2,False,0.02,86,False,vs_left,b,2150,57,30,27,2179,1985,194,0.5263157894736842
8040,0.2,False,0.02,86,False,difference,b,2150,0,0,0,2236,2012,224,0.0
8040,0.2,False,0.02,64,True,baseline,b,450,0,0,0,468,324,144,0.0
8040,0.2,False,0.02,64,True,vs_right,b,450,25,24,1,443,323,120,0.96
8040,0.2,False,0.02,64,True,vs_left,b,450,34,34,0,434,324,110,1.0
8040,0.2,False,0.02,64,True,difference,b,450,0,0,0,468,324,144,0.0
8040,0.2,False,0.02,64,False,baseline,b,1600,0,0,0,1664,1520,144,0.0
8040,0.2,False,0.02,64,False,vs_right,b,1600,43,14,29,1621,1491,130,0.32558139534883723
8040,0.2,False,0.02,64,False,vs_left,b,1600,55,29,26,1609,1494,115,0.5272727272727272
8040,0.2,False,0.02,64,False,difference,b,1600,0,0,0,1664,1520,144,0.0
8040,0.2,False,0.02,31,True,baseline,b,200,0,0,0,208,144,64,0.0
8040,0.2,False,0.02,31,True,vs_right,b,200,15,14,1,193,143,50,0.9333333333333333
8040,0.2,False,0.02,31,True,vs_left,b,200,14,14,0,194,144,50,1.0
8040,0.2,False,0.02,31,True,difference,b,200,0,0,0,208,144,64,0.0
8040,0.2,False,0.02,31,False,baseline,b,775,0,0,0,806,742,64,0.0
8040,0.2,False,0.02,31,False,vs_right,b,775,28,6,22,778,720,58,0.21428571428571427
8040,0.2,False,0.02,31,False,vs_left,b,775,32,14,18,774,724,50,0.4375
8040,0.2,False,0.02,31,False,difference,b,775,0,0,0,806,742,64,0.0
8030,0.1,True,0.004,86,True,baseline,w,3500,14,4,10,3514,2454,1060,0.2857142857142857
8030,0.1,True,0.004,86,True,vs_right,w,3500,422,398,24,3106,2440,666,0.943127962085308
8030,0.1,True,0.004,86,True,vs_left,w,3500,460,437,23,3068,2441,627,0.95
8030,0.1,True,0.004,86,True,difference,w,3500,25,7,18,3503,2446,1057,0.28
8030,0.1,True,0.004,86,False,baseline,w,10750,26,2,24,10810,9748,1062,0.07692307692307693
8030,0.1,True,0.004,86,False,vs_right,w,10750,778,349,429,10058,9343,715,0.448586118251928
8030,0.1,True,0.004,86,False,vs_left,w,10750,844,396,448,9992,9324,668,0.46919431279620855
8030,0.1,True,0.004,86,False,difference,w,10750,34,2,32,10802,9740,1062,0.058823529411764705
8030,0.1,True,0.004,64,True,baseline,w,2250,17,4,13,2251,1571,680,0.23529411764705882
8030,0.1,True,0.004,64,True,vs_right,w,2250,328,302,26,1940,1558,382,0.9207317073170732
8030,0.1,True,0.004,64,True,vs_left,w,2250,334,313,21,1934,1563,371,0.937125748502994
8030,0.1,True,0.004,64,True,difference,w,2250,24,4,20,2244,1564,680,0.16666666666666666
8030,0.1,True,0.004,64,False,baseline,w,8000,30,2,28,8034,7352,682,0.06666666666666667
8030,0.1,True,0.004,64,False,vs_right,w,8000,612,264,348,7452,7032,420,0.43137254901960786
8030,0.1,True,0.004,64,False,vs_left,w,8000,637,281,356,7427,7024,403,0.4411302982731554
8030,0.1,True,0.004,64,False,difference,w,8000,36,0,36,8028,7344,684,0.0
8030,0.1,True,0.004,31,True,baseline,w,1000,16,2,14,992,690,302,0.125
8030,0.1,True,0.004,31,True,vs_right,w,1000,151,137,14,857,690,167,0.9072847682119205
8030,0.1,True,0.004,31,True,vs_left,w,1000,159,143,16,849,688,161,0.89937106918239
8030,0.1,True,0.004,31,True,difference,w,1000,11,3,8,997,696,301,0.2727272727272727
8030,0.1,True,0.004,31,False,baseline,w,3875,25,2,23,3881,3579,302,0.08
8030,0.1,True,0.004,31,False,vs_right,w,3875,319,124,195,3587,3407,180,0.3887147335423197
8030,0.1,True,0.004,31,False,vs_left,w,3875,334,130,204,3572,3398,174,0.38922155688622756
8030,0.1,True,0.004,31,False,difference,w,3875,20,0,20,3886,3582,304,0.0
8030,0.1,True,0.012,86,True,baseline,w,1148,3,0,3,1173,837,336,0.0
8030,0.1,True,0.012,86,True,vs_right,w,1148,148,141,7,1028,833,195,0.9527027027027027
8030,0.1,True,0.012,86,True,vs_left,w,1148,164,162,2,1012,838,174,0.9878048780487805
8030,0.1,True,0.012,86,True,difference,w,1148,7,2,5,1169,835,334,0.2857142857142857
8030,0.1,True,0.012,86,False,baseline,w,3526,5,0,5,3607,3271,336,0.0
8030,0.1,True,0.012,86,False,vs_right,w,3526,267,128,139,3345,3137,208,0.4794007490636704
8030,0.1,True,0.012,86,False,vs_left,w,3526,287,145,142,3325,3134,191,0.5052264808362369
8030,0.1,True,0.012,86,False,difference,w,3526,5,0,5,3607,3271,336,0.0
8030,0.1,True,0.012,64,True,baseline,w,738,3,0,3,753,537,216,0.0
8030,0.1,True,0.012,64,True,vs_right,w,738,111,103,8,645,532,113,0.9279279279279279
8030,0.1,True,0.012,64,True,vs_left,w,738,116,112,4,640,536,104,0.9655172413793104
8030,0.1,True,0.012,64,True,difference,w,738,5,0,5,751,535,216,0.0
8030,0.1,True,0.012,64,False,baseline,w,2624,7,0,7,2681,2465,216,0.0
8030,0.1,True,0.012,64,False,vs_right,w,2624,206,96,110,2482,2362,120,0.46601941747572817
8030,0.1,True,0.012,64,False,vs_left,w,2624,213,100,113,2475,2359,116,0.4694835680751174
8030,0.1,True,0.012,64,False,difference,w,2624,5,0,5,2683,2467,216,0.0
8030,0.1,True,0.012,31,True,baseline,w,328,2,0,2,334,238,96,0.0
8030,0.1,True,0.012,31,True,vs_right,w,328,51,46,5,285,235,50,0.9019607843137255
8030,0.1,True,0.012,31,True,vs_left,w,328,57,53,4,279,236,43,0.9298245614035088
8030,0.1,True,0.012,31,True,difference,w,328,2,2,0,334,240,94,1.0
8030,0.1,True,0.012,31,False,baseline,w,1271,6,0,6,1296,1200,96,0.0
8030,0.1,True,0.012,31,False,vs_right,w,1271,109,44,65,1193,1141,52,0.4036697247706422
8030,0.1,True,0.012,31,False,vs_left,w,1271,111,45,66,1191,1140,51,0.40540540540540543
8030,0.1,True,0.012,31,False,difference,w,1271,3,0,3,1299,1203,96,0.0
8030,0.1,True,0.02,86,True,baseline,w,700,3,0,3,725,501,224,0.0
8030,0.1,True,0.02,86,True,vs_right,w,700,75,73,2,653,502,151,0.9733333333333334
8030,0.1,True,0.02,86,True,vs_left,w,700,87,87,0,641,504,137,1.0
8030,0.1,True,0.02,86,True,difference,w,700,2,0,2,726,502,224,0.0
8030,0.1,True,0.02,86,False,baseline,w,2150,1,0,1,2235,2011,224,0.0
8030,0.1,True,0.02,86,False,vs_right,w,2150,130,66,64,2106,1948,158,0.5076923076923077
8030,0.1,True,0.02,86,False,vs_left,w,2150,109,65,44,2127,1968,159,0.5963302752293578
8030,0.1,True,0.02,86,False,difference,w,2150,2,0,2,2234,2010,224,0.0
8030,0.1,True,0.02,64,True,baseline,w,450,3,0,3,465,321,144,0.0
8030,0.1,True,0.02,64,True,vs_right,w,450,55,53,2,413,322,91,0.9636363636363636
8030,0.1,True,0.02,64,True,vs_left,w,450,66,66,0,402,324,78,1.0
8030,0.1,True,0.02,64,True,difference,w,450,2,0,2,466,322,144,0.0
8030,0.1,True,0.02,64,False,baseline,w,1600,3,0,3,1661,1517,144,0.0
8030,0.1,True,0.02,64,False,vs_right,w,1600,95,48,47,1569,1473,96,0.5052631578947369
8030,0.1,True,0.02,64,False,vs_left,w,1600,82,44,38,1582,1482,100,0.5365853658536586
8030,0.1,True,0.02,64,False,difference,w,1600,4,0,4,1660,1516,144,0.0
8030,0.1,True,0.02,31,True,baseline,w,200,2,0,2,206,142,64,0.0
8030,0.1,True,0.02,31,True,vs_right,w,200,26,26,0,182,144,38,1.0
8030,0.1,True,0.02,31,True,vs_left,w,200,33,33,0,175,144,31,1.0
8030,0.1,True,0.02,31,True,difference,w,200,0,0,0,208,144,64,0.0
8030,0.1,True,0.02,31,False,baseline,w,775,2,0,2,804,740,64,0.0
8030,0.1,True,0.02,31,False,vs_right,w,775,55,22,33,751,709,42,0.4
8030,0.1,True,0.02,31,False,vs_left,w,775,46,25,21,760,721,39,0.5434782608695652
8030,0.1,True,0.02,31,False,difference,w,775,1,0,1,805,741,64,0.0
8030,0.1,True,0.004,86,True,baseline,b,3500,0,0,0,3528,2464,1064,0.0
8030,0.1,True,0.004,86,True,vs_right,b,3500,42,42,0,3486,2464,1022,1.0
8030,0.1,True,0.004,86,True,vs_left,b,3500,43,43,0,3485,2464,1021,1.0
8030,0.1,True,0.004,86,True,difference,b,3500,0,0,0,3528,2464,1064,0.0
8030,0.1,True,0.004,86,False,baseline,b,10750,0,0,0,10836,9772,1064,0.0
8030,0.1,True,0.004,86,False,vs_right,b,10750,24,12,12,10812,9760,1052,0.5
8030,0.1,True,0.004,86,False,vs_left,b,10750,10,3,7,10826,9765,1061,0.3
8030,0.1,True,0.004,86,False,difference,b,10750,0,0,0,10836,9772,1064,0.0
8030,0.1,True,0.004,64,True,baseline,b,2250,0,0,0,2268,1584,684,0.0
8030,0.1,True,0.004,64,True,vs_right,b,2250,39,39,0,2229,1584,645,1.0
8030,0.1,True,0.004,64,True,vs_left,b,2250,57,57,0,2211,1584,627,1.0
8030,0.1,True,0.004,64,True,difference,b,2250,0,0,0,2268,1584,684,0.0
8030,0.1,True,0.004,64,False,baseline,b,8000,0,0,0,8064,7380,684,0.0
8030,0.1,True,0.004,64,False,vs_right,b,8000,23,11,12,8041,7368,673,0.4782608695652174
8030,0.1,True,0.004,64,False,vs_left,b,8000,18,10,8,8046,7372,674,0.5555555555555556
8030,0.1,True,0.004,64,False,difference,b,8000,0,0,0,8064,7380,684,0.0
8030,0.1,True,0.004,31,True,baseline,b,1000,0,0,0,1008,704,304,0.0
8030,0.1,True,0.004,31,True,vs_right,b,1000,25,25,0,983,704,279,1.0
8030,0.1,True,0.004,31,True,vs_left,b,1000,36,35,1,972,703,269,0.9722222222222222
8030,0.1,True,0.004,31,True,difference,b,1000,0,0,0,1008,704,304,0.0
8030,0.1,True,0.004,31,False,baseline,b,3875,0,0,0,3906,3602,304,0.0
8030,0.1,True,0.004,31,False,vs_right,b,3875,25,11,14,3881,3588,293,0.44
8030,0.1,True,0.004,31,False,vs_left,b,3875,19,8,11,3887,3591,296,0.42105263157894735
8030,0.1,True,0.004,31,False,difference,b,3875,0,0,0,3906,3602,304,0.0
8030,0.1,True,0.012,86,True,baseline,b,1148,0,0,0,1176,840,336,0.0
8030,0.1,True,0.012,86,True,vs_right,b,1148,26,26,0,1150,840,310,1.0
8030,0.1,True,0.012,86,True,vs_left,b,1148,42,41,1,1134,839,295,0.9761904761904762
8030,0.1,True,0.012,86,True,difference,b,1148,1,0,1,1175,839,336,0.0
8030,0.1,True,0.012,86,False,baseline,b,3526,0,0,0,3612,3276,336,0.0
8030,0.1,True,0.012,86,False,vs_right,b,3526,19,12,7,3593,3269,324,0.631578947368421
8030,0.1,True,0.012,86,False,vs_left,b,3526,16,10,6,3596,3270,326,0.625
8030,0.1,True,0.012,86,False,difference,b,3526,0,0,0,3612,3276,336,0.0
8030,0.1,True,0.012,64,True,baseline,b,738,0,0,0,756,540,216,0.0
8030,0.1,True,0.012,64,True,vs_right,b,738,22,22,0,734,540,194,1.0
8030,0.1,True,0.012,64,True,vs_left,b,738,38,37,1,718,539,179,0.9736842105263158
8030,0.1,True,0.012,64,True,difference,b,738,1,0,1,755,539,216,0.0
8030,0.1,True,0.012,64,False,baseline,b,2624,0,0,0,2688,2472,216,0.0
8030,0.1,True,0.012,64,False,vs_right,b,2624,16,9,7,2672,2465,207,0.5625
8030,0.1,True,0.012,64,False,vs_left,b,2624,21,15,6,2667,2466,201,0.7142857142857143
8030,0.1,True,0.012,64,False,difference,b,2624,0,0,0,2688,2472,216,0.0
8030,0.1,True,0.012,31,True,baseline,b,328,0,0,0,336,240,96,0.0
8030,0.1,True,0.012,31,True,vs_right,b,328,13,13,0,323,240,83,1.0
8030,0.1,True,0.012,31,True,vs_left,b,328,18,17,1,318,239,79,0.9444444444444444
8030,0.1,True,0.012,31,True,difference,b,328,0,0,0,336,240,96,0.0
8030,0.1,True,0.012,31,False,baseline,b,1271,0,0,0,1302,1206,96,0.0
8030,0.1,True,0.012,31,False,vs_right,b,1271,13,7,6,1289,1200,89,0.5384615384615384
8030,0.1,True,0.012,31,False,vs_left,b,1271,20,12,8,1282,1198,84,0.6
8030,0.1,True,0.012,31,False,difference,b,1271,0,0,0,1302,1206,96,0.0
8030,0.1,True,0.02,86,True,baseline,b,700,0,0,0,728,504,224,0.0
8030,0.1,True,0.02,86,True,vs_right,b,700,21,21,0,707,504,203,1.0
8030,0.1,True,0.02,86,True,vs_left,b,700,33,32,1,695,503,192,0.9696969696969697
8030,0.1,True,0.02,86,True,difference,b,700,0,0,0,728,504,224,0.0
8030,0.1,True,0.02,86,False,baseline,b,2150,0,0,0,2236,2012,224,0.0
8030,0.1,True,0.02,86,False,vs_right,b,2150,15,11,4,2221,2008,213,0.7333333333333333
8030,0.1,True,0.02,86,False,vs_left,b,2150,28,21,7,2208,2005,203,0.75
8030,0.1,True,0.02,86,False,difference,b,2150,0,0,0,2236,2012,224,0.0
8030,0.1,True,0.02,64,True,baseline,b,450,0,0,0,468,324,144,0.0
8030,0.1,True,0.02,64,True,vs_right,b,450,15,15,0,453,324,129,1.0
8030,0.1,True,0.02,64,True,vs_left,b,450,26,25,1,442,323,119,0.9615384615384616
8030,0.1,True,0.02,64,True,difference,b,450,0,0,0,468,324,144,0.0
8030,0.1,True,0.02,64,False,baseline,b,1600,0,0,0,1664,1520,144,0.0
8030,0.1,True,0.02,64,False,vs_right,b,1600,14,9,5,1650,1515,135,0.6428571428571429
8030,0.1,True,0.02,64,False,vs_left,b,1600,26,18,8,1638,1512,126,0.6923076923076923
8030,0.1,True,0.02,64,False,difference,b,1600,0,0,0,1664,1520,144,0.0
8030,0.1,True,0.02,31,True,baseline,b,200,0,0,0,208,144,64,0.0
8030,0.1,True,0.02,31,True,vs_right,b,200,12,12,0,196,144,52,1.0
8030,0.1,True,0.02,31,True,vs_left,b,200,12,11,1,196,143,53,0.9166666666666666
8030,0.1,True,0.02,31,True,difference,b,200,0,0,0,208,144,64,0.0
8030,0.1,True,0.02,31,False,baseline,b,775,0,0,0,806,742,64,0.0
8030,0.1,True,0.02,31,False,vs_right,b,775,9,5,4,797,738,59,0.5555555555555556
8030,0.1,True,0.02,31,False,vs_left,b,775,18,10,8,788,734,54,0.5555555555555556
8030,0.1,True,0.02,31,False,difference,b,775,0,0,0,806,742,64,0.0
8030,0.1,False,0.004,86,True,baseline,w,3500,16,4,12,3512,2452,1060,0.25
8030,0.1,False,0.004,86,True,vs_right,w,3500,415,399,16,3113,2448,665,0.9614457831325302
8030,0.1,False,0.004,86,True,vs_left,w,3500,411,401,10,3117,2454,663,0.975669099756691
8030,0.1,False,0.004,86,True,difference,w,3500,17,13,4,3511,2460,1051,0.7647058823529411
8030,0.1,False,0.004,86,False,baseline,w,10750,16,3,13,10820,9759,1061,0.1875
8030,0.1,False,0.004,86,False,vs_right,w,10750,737,349,388,10099,9384,715,0.4735413839891452
8030,0.1,False,0.004,86,False,vs_left,w,10750,740,361,379,10096,9393,703,0.48783783783783785
8030,0.1,False,0.004,86,False,difference,w,10750,27,7,20,10809,9752,1057,0.25925925925925924
8030,0.1,False,0.004,64,True,baseline,w,2250,5,0,5,2263,1579,684,0.0
8030,0.1,False,0.004,64,True,vs_right,w,2250,309,300,9,1959,1575,384,0.970873786407767
8030,0.1,False,0.004,64,True,vs_left,w,2250,313,301,12,1955,1572,383,0.9616613418530351
8030,0.1,False,0.004,64,True,difference,w,2250,12,10,2,2256,1582,674,0.8333333333333334
8030,0.1,False,0.004,64,False,baseline,w,8000,13,0,13,8051,7367,684,0.0
8030,0.1,False,0.004,64,False,vs_right,w,8000,589,264,325,7475,7055,420,0.44821731748726656
8030,0.1,False,0.004,64,False,vs_left,w,8000,599,266,333,7465,7047,418,0.44407345575959933
8030,0.1,False,0.004,64,False,difference,w,8000,22,3,19,8042,7361,681,0.13636363636363635
8030,0.1,False,0.004,31,True,baseline,w,1000,6,0,6,1002,698,304,0.0
8030,0.1,False,0.004,31,True,vs_right,w,1000,149,143,6,859,698,161,0.959731543624161
8030,0.1,False,0.004,31,True,vs_left,w,1000,141,138,3,867,701,166,0.9787234042553191
8030,0.1,False,0.004,31,True,difference,w,1000,12,10,2,996,702,294,0.8333333333333334
8030,0.1,False,0.004,31,False,baseline,w,3875,12,0,12,3894,3590,304,0.0
8030,0.1,False,0.004,31,False,vs_right,w,3875,304,123,181,3602,3421,181,0.40460526315789475
8030,0.1,False,0.004,31,False,vs_left,w,3875,297,115,182,3609,3420,189,0.3872053872053872
8030,0.1,False,0.004,31,False,difference,w,3875,10,4,6,3896,3596,300,0.4
8030,0.1,False,0.012,86,True,baseline,w,1148,2,0,2,1174,838,336,0.0
8030,0.1,False,0.012,86,True,vs_right,w,1148,152,145,7,1024,833,191,0.9539473684210527
8030,0.1,False,0.012,86,True,vs_left,w,1148,154,154,0,1022,840,182,1.0
8030,0.1,False,0.012,86,True,difference,w,1148,8,8,0,1168,840,328,1.0
8030,0.1,False,0.012,86,False,baseline,w,3526,4,0,4,3608,3272,336,0.0
8030,0.1,False,0.012,86,False,vs_right,w,3526,283,135,148,3329,3128,201,0.47703180212014135
8030,0.1,False,0.012,86,False,vs_left,w,3526,256,130,126,3356,3150,206,0.5078125
8030,0.1,False,0.012,86,False,difference,w,3526,4,2,2,3608,3274,334,0.5
8030,0.1,False,0.012,64,True,baseline,w,738,2,0,2,754,538,216,0.0
8030,0.1,False,0.012,64,True,vs_right,w,738,110,107,3,646,537,109,0.9727272727272728
8030,0.1,False,0.012,64,True,vs_left,w,738,113,113,0,643,540,103,1.0
8030,0.1,False,0.012,64,True,difference,w,738,6,6,0,750,540,210,1.0
8030,0.1,False,0.012,64,False,baseline,w,2624,3,0,3,2685,2469,216,0.0
8030,0.1,False,0.012,64,False,vs_right,w,2624,223,100,123,2465,2349,116,0.4484304932735426
8030,0.1,False,0.012,64,False,vs_left,w,2624,209,97,112,2479,2360,119,0.46411483253588515
8030,0.1,False,0.012,64,False,difference,w,2624,2,0,2,2686,2470,216,0.0
8030,0.1,False,0.012,31,True,baseline,w,328,2,0,2,334,238,96,0.0
8030,0.1,False,0.012,31,True,vs_right,w,328,52,50,2,284,238,46,0.9615384615384616
8030,0.1,False,0.012,31,True,vs_left,w,328,54,52,2,282,238,44,0.9629629629629629
8030,0.1,False,0.012,31,True,difference,w,328,5,5,0,331,240,91,1.0
8030,0.1,False,0.012,31,False,baseline,w,1271,0,0,0,1302,1206,96,0.0
8030,0.1,False,0.012,31,False,vs_right,w,1271,112,47,65,1190,1141,49,0.41964285714285715
8030,0.1,False,0.012,31,False,vs_left,w,1271,115,48,67,1187,1139,48,0.41739130434782606
8030,0.1,False,0.012,31,False,difference,w,1271,4,4,0,1298,1206,92,1.0
8030,0.1,False,0.02,86,True,baseline,w,700,1,0,1,727,503,224,0.0
8030,0.1,False,0.02,86,True,vs_right,w,700,80,79,1,648,503,145,0.9875
8030,0.1,False,0.02,86,True,vs_left,w,700,77,77,0,651,504,147,1.0
8030,0.1,False,0.02,86,True,difference,w,700,4,4,0,724,504,220,1.0
8030,0.1,False,0.02,86,False,baseline,w,2150,2,0,2,2234,2010,224,0.0
8030,0.1,False,0.02,86,False,vs_right,w,2150,141,63,78,2095,1934,161,0.44680851063829785
8030,0.1,False,0.02,86,False,vs_left,w,2150,111,62,49,2125,1963,162,0.5585585585585585
8030,0.1,False,0.02,86,False,difference,w,2150,0,0,0,2236,2012,224,0.0
8030,0.1,False,0.02,64,True,baseline,w,450,0,0,0,468,324,144,0.0
8030,0.1,False,0.02,64,True,vs_right,w,450,56,56,0,412,324,88,1.0
8030,0.1,False,0.02,64,True,vs_left,w,450,56,56,0,412,324,88,1.0
8030,0.1,False,0.02,64,True,difference,w,450,2,2,0,466,324,142,1.0
8030,0.1,False,0.02,64,False,baseline,w,1600,1,0,1,1663,1519,144,0.0
8030,0.1,False,0.02,64,False,vs_right,w,1600,109,52,57,1555,1463,92,0.47706422018348627
8030,0.1,False,0.02,64,False,vs_left,w,1600,107,51,56,1557,1464,93,0.4766355140186916
8030,0.1,False,0.02,64,False,difference,w,1600,0,0,0,1664,1520,144,0.0
8030,0.1,False,0.02,31,True,baseline,w,200,0,0,0,208,144,64,0.0
8030,0.1,False,0.02,31,True,vs_right,w,200,28,26,2,180,142,38,0.9285714285714286
8030,0.1,False,0.02,31,True,vs_left,w,200,31,31,0,177,144,33,1.0
8030,0.1,False,0.02,31,True,difference,w,200,2,2,0,206,144,62,1.0
8030,0.1,False,0.02,31,False,baseline,w,775,0,0,0,806,742,64,0.0
8030,0.1,False,0.02,31,False,vs_right,w,775,60,23,37,746,705,41,0.38333333333333336
8030,0.1,False,0.02,31,False,vs_left,w,775,62,23,39,744,703,41,0.3709677419354839
8030,0.1,False,0.02,31,False,difference,w,775,2,2,0,804,742,62,1.0
8030,0.1,False,0.004,86,True,baseline,b,3500,0,0,0,3528,2464,1064,0.0
8030,0.1,False,0.004,86,True,vs_right,b,3500,48,48,0,3480,2464,1016,1.0
8030,0.1,False,0.004,86,True,vs_left,b,3500,35,35,0,3493,2464,1029,1.0
8030,0.1,False,0.004,86,True,difference,b,3500,0,0,0,3528,2464,1064,0.0
8030,0.1,False,0.004,86,False,baseline,b,10750,0,0,0,10836,9772,1064,0.0
8030,0.1,False,0.004,86,False,vs_right,b,10750,19,14,5,10817,9767,1050,0.7368421052631579
8030,0.1,False,0.004,86,False,vs_left,b,10750,22,7,15,10814,9757,1057,0.3181818181818182
8030,0.1,False,0.004,86,False,difference,b,10750,0,0,0,10836,9772,1064,0.0
8030,0.1,False,0.004,64,True,baseline,b,2250,0,0,0,2268,1584,684,0.0
8030,0.1,False,0.004,64,True,vs_right,b,2250,45,45,0,2223,1584,639,1.0
8030,0.1,False,0.004,64,True,vs_left,b,2250,36,36,0,2232,1584,648,1.0
8030,0.1,False,0.004,64,True,difference,b,2250,0,0,0,2268,1584,684,0.0
8030,0.1,False,0.004,64,False,baseline,b,8000,0,0,0,8064,7380,684,0.0
8030,0.1,False,0.004,64,False,vs_right,b,8000,19,15,4,8045,7376,669,0.7894736842105263
8030,0.1,False,0.004,64,False,vs_left,b,8000,28,9,19,8036,7361,675,0.32142857142857145
8030,0.1,False,0.004,64,False,difference,b,8000,0,0,0,8064,7380,684,0.0
8030,0.1,False,0.004,31,True,baseline,b,1000,0,0,0,1008,704,304,0.0
8030,0.1,False,0.004,31,True,vs_right,b,1000,32,32,0,976,704,272,1.0
8030,0.1,False,0.004,31,True,vs_left,b,1000,29,29,0,979,704,275,1.0
8030,0.1,False,0.004,31,True,difference,b,1000,0,0,0,1008,704,304,0.0
8030,0.1,False,0.004,31,False,baseline,b,3875,0,0,0,3906,3602,304,0.0
8030,0.1,False,0.004,31,False,vs_right,b,3875,16,13,3,3890,3599,291,0.8125
8030,0.1,False,0.004,31,False,vs_left,b,3875,26,10,16,3880,3586,294,0.38461538461538464
8030,0.1,False,0.004,31,False,difference,b,3875,0,0,0,3906,3602,304,0.0
8030,0.1,False,0.012,86,True,baseline,b,1148,0,0,0,1176,840,336,0.0
8030,0.1,False,0.012,86,True,vs_right,b,1148,30,30,0,1146,840,306,1.0
8030,0.1,False,0.012,86,True,vs_left,b,1148,33,33,0,1143,840,303,1.0
8030,0.1,False,0.012,86,True,difference,b,1148,0,0,0,1176,840,336,0.0
8030,0.1,False,0.012,86,False,baseline,b,3526,0,0,0,3612,3276,336,0.0
8030,0.1,False,0.012,86,False,vs_right,b,3526,17,14,3,3595,3273,322,0.8235294117647058
8030,0.1,False,0.012,86,False,vs_left,b,3526,22,13,9,3590,3267,323,0.5909090909090909
8030,0.1,False,0.012,86,False,difference,b,3526,0,0,0,3612,3276,336,0.0
8030,0.1,False,0.012,64,True,baseline,b,738,0,0,0,756,540,216,0.0
8030,0.1,False,0.012,64,True,vs_right,b,738,29,29,0,727,540,187,1.0
8030,0.1,False,0.012,64,True,vs_left,b,738,30,30,0,726,540,186,1.0
8030,0.1,False,0.012,64,True,difference,b,738,0,0,0,756,540,216,0.0
8030,0.1,False,0.012,64,False,baseline,b,2624,0,0,0,2688,2472,216,0.0
8030,0.1,False,0.012,64,False,vs_right,b,2624,17,12,5,2671,2467,204,0.7058823529411765
8030,0.1,False,0.012,64,False,vs_left,b,2624,24,12,12,2664,2460,204,0.5
8030,0.1,False,0.012,64,False,difference,b,2624,0,0,0,2688,2472,216,0.0
8030,0.1,False,0.012,31,True,baseline,b,328,0,0,0,336,240,96,0.0
8030,0.1,False,0.012,31,True,vs_right,b,328,14,14,0,322,240,82,1.0
8030,0.1,False,0.012,31,True,vs_left,b,328,19,19,0,317,240,77,1.0
8030,0.1,False,0.012,31,True,difference,b,328,0,0,0,336,240,96,0.0
8030,0.1,False,0.012,31,False,baseline,b,1271,0,0,0,1302,1206,96,0.0
8030,0.1,False,0.012,31,False,vs_right,b,1271,14,9,5,1288,1201,87,0.6428571428571429
8030,0.1,False,0.012,31,False,vs_left,b,1271,18,9,9,1284,1197,87,0.5
8030,0.1,False,0.012,31,False,difference,b,1271,0,0,0,1302,1206,96,0.0
8030,0.1,False,0.02,86,True,baseline,b,700,0,0,0,728,504,224,0.0
8030,0.1,False,0.02,86,True,vs_right,b,700,24,24,0,704,504,200,1.0
8030,0.1,False,0.02,86,True,vs_left,b,700,29,29,0,699,504,195,1.0
8030,0.1,False,0.02,86,True,difference,b,700,0,0,0,728,504,224,0.0
8030,0.1,False,0.02,86,False,baseline,b,2150,0,0,0,2236,2012,224,0.0
8030,0.1,False,0.02,86,False,vs_right,b,2150,18,13,5,2218,2007,211,0.7222222222222222
8030,0.1,False,0.02,86,False,vs_left,b,2150,22,14,8,2214,2004,210,0.6363636363636364
8030,0.1,False,0.02,86,False,difference,b,2150,0,0,0,2236,2012,224,0.0
8030,0.1,False,0.02,64,True,baseline,b,450,0,0,0,468,324,144,0.0
8030,0.1,False,0.02,64,True,vs_right,b,450,21,21,0,447,324,123,1.0
8030,0.1,False,0.02,64,True,vs_left,b,450,23,23,0,445,324,121,1.0
8030,0.1,False,0.02,64,True,difference,b,450,0,0,0,468,324,144,0.0
8030,0.1,False,0.02,64,False,baseline,b,1600,0,0,0,1664,1520,144,0.0
8030,0.1,False,0.02,64,False,vs_right,b,1600,18,12,6,1646,1514,132,0.6666666666666666
8030,0.1,False,0.02,64,False,vs_left,b,1600,20,12,8,1644,1512,132,0.6
8030,0.1,False,0.02,64,False,difference,b,1600,0,0,0,1664,1520,144,0.0
8030,0.1,False,0.02,31,True,baseline,b,200,0,0,0,208,144,64,0.0
8030,0.1,False,0.02,31,True,vs_right,b,200,12,12,0,196,144,52,1.0
8030,0.1,False,0.02,31,True,vs_left,b,200,12,12,0,196,144,52,1.0
8030,0.1,False,0.02,31,True,difference,b,200,0,0,0,208,144,64,0.0
8030,0.1,False,0.02,31,False,baseline,b,775,0,0,0,806,742,64,0.0
8030,0.1,False,0.02,31,False,vs_right,b,775,13,8,5,793,737,56,0.6153846153846154
8030,0.1,False,0.02,31,False,vs_left,b,775,15,10,5,791,737,54,0.6666666666666666
8030,0.1,False,0.02,31,False,difference,b,775,0,0,0,806,742,64,0.0
8030,0.2,True,0.004,86,True,baseline,w,3500,20,5,15,3508,2449,1059,0.25
8030,0.2,True,0.004,86,True,vs_right,w,3500,526,482,44,3002,2420,582,0.9163498098859315
8030,0.2,True,0.004,86,True,vs_left,w,3500,494,473,21,3034,2443,591,0.9574898785425101
8030,0.2,True,0.004,86,True,difference,w,3500,33,22,11,3495,2453,1042,0.6666666666666666
8030,0.2,True,0.004,86,False,baseline,w,10750,21,3,18,10815,9754,1061,0.14285714285714285
8030,0.2,True,0.004,86,False,vs_right,w,10750,1275,443,832,9561,8940,621,0.3474509803921569
8030,0.2,True,0.004,86,False,vs_left,w,10750,1188,433,755,9648,9017,631,0.36447811447811446
8030,0.2,True,0.004,86,False,difference,w,10750,32,9,23,10804,9749,1055,0.28125
8030,0.2,True,0.004,64,True,baseline,w,2250,21,9,12,2247,1572,675,0.42857142857142855
8030,0.2,True,0.004,64,True,vs_right,w,2250,379,345,34,1889,1550,339,0.9102902374670184
8030,0.2,True,0.004,64,True,vs_left,w,2250,361,337,24,1907,1560,347,0.9335180055401662
8030,0.2,True,0.004,64,True,difference,w,2250,21,11,10,2247,1574,673,0.5238095238095238
8030,0.2,True,0.004,64,False,baseline,w,8000,18,3,15,8046,7365,681,0.16666666666666666
8030,0.2,True,0.004,64,False,vs_right,w,8000,979,320,659,7085,6721,364,0.3268641470888662
8030,0.2,True,0.004,64,False,vs_left,w,8000,907,312,595,7157,6785,372,0.3439911797133407
8030,0.2,True,0.004,64,False,difference,w,8000,26,3,23,8038,7357,681,0.11538461538461539
8030,0.2,True,0.004,31,True,baseline,w,1000,9,5,4,999,700,299,0.5555555555555556
8030,0.2,True,0.004,31,True,vs_right,w,1000,171,151,20,837,684,153,0.8830409356725146
8030,0.2,True,0.004,31,True,vs_left,w,1000,171,151,20,837,684,153,0.8830409356725146
8030,0.2,True,0.004,31,True,difference,w,1000,22,11,11,986,693,293,0.5
8030,0.2,True,0.004,31,False,baseline,w,3875,17,2,15,3889,3587,302,0.11764705882352941
8030,0.2,True,0.004,31,False,vs_right,w,3875,497,135,362,3409,3240,169,0.2716297786720322
8030,0.2,True,0.004,31,False,vs_left,w,3875,453,137,316,3453,3286,167,0.30242825607064017
8030,0.2,True,0.004,31,False,difference,w,3875,36,6,30,3870,3572,298,0.16666666666666666
8030,0.2,True,0.012,86,True,baseline,w,1148,2,0,2,1174,838,336,0.0
8030,0.2,True,0.012,86,True,vs_right,w,1148,189,167,22,987,818,169,0.8835978835978836
8030,0.2,True,0.012,86,True,vs_left,w,1148,184,176,8,992,832,160,0.9565217391304348
8030,0.2,True,0.012,86,True,difference,w,1148,12,10,2,1164,838,326,0.8333333333333334
8030,0.2,True,0.012,86,False,baseline,w,3526,3,0,3,3609,3273,336,0.0
8030,0.2,True,0.012,86,False,vs_right,w,3526,466,159,307,3146,2969,177,0.34120171673819744
8030,0.2,True,0.012,86,False,vs_left,w,3526,402,149,253,3210,3023,187,0.3706467661691542
8030,0.2,True,0.012,86,False,difference,w,3526,11,4,7,3601,3269,332,0.36363636363636365
8030,0.2,True,0.012,64,True,baseline,w,738,2,0,2,754,538,216,0.0
8030,0.2,True,0.012,64,True,vs_right,w,738,132,117,15,624,525,99,0.8863636363636364
8030,0.2,True,0.012,64,True,vs_left,w,738,128,124,4,628,536,92,0.96875
8030,0.2,True,0.012,64,True,difference,w,738,10,6,4,746,536,210,0.6
8030,0.2,True,0.012,64,False,baseline,w,2624,3,0,3,2685,2469,216,0.0
8030,0.2,True,0.012,64,False,vs_right,w,2624,361,112,249,2327,2223,104,0.31024930747922436
8030,0.2,True,0.012,64,False,vs_left,w,2624,312,103,209,2376,2263,113,0.3301282051282051
8030,0.2,True,0.012,64,False,difference,w,2624,9,2,7,2679,2465,214,0.2222222222222222
8030,0.2,True,0.012,31,True,baseline,w,328,0,0,0,336,240,96,0.0
8030,0.2,True,0.012,31,True,vs_right,w,328,56,49,7,280,233,47,0.875
8030,0.2,True,0.012,31,True,vs_left,w,328,57,55,2,279,238,41,0.9649122807017544
8030,0.2,True,0.012,31,True,difference,w,328,6,4,2,330,238,92,0.6666666666666666
8030,0.2,True,0.012,31,False,baseline,w,1271,3,0,3,1299,1203,96,0.0
8030,0.2,True,0.012,31,False,vs_right,w,1271,179,47,132,1123,1074,49,0.26256983240223464
8030,0.2,True,0.012,31,False,vs_left,w,1271,156,48,108,1146,1098,48,0.3076923076923077
8030,0.2,True,0.012,31,False,difference,w,1271,11,2,9,1291,1197,94,0.18181818181818182
8030,0.2,True,0.02,86,True,baseline,w,700,0,0,0,728,504,224,0.0
8030,0.2,True,0.02,86,True,vs_right,w,700,106,96,10,622,494,128,0.9056603773584906
8030,0.2,True,0.02,86,True,vs_left,w,700,95,92,3,633,501,132,0.968421052631579
8030,0.2,True,0.02,86,True,difference,w,700,2,0,2,726,502,224,0.0
8030,0.2,True,0.02,86,False,baseline,w,2150,2,0,2,2234,2010,224,0.0
8030,0.2,True,0.02,86,False,vs_right,w,2150,245,85,160,1991,1852,139,0.3469387755102041
8030,0.2,True,0.02,86,False,vs_left,w,2150,160,71,89,2076,1923,153,0.44375
8030,0.2,True,0.02,86,False,difference,w,2150,4,0,4,2232,2008,224,0.0
8030,0.2,True,0.02,64,True,baseline,w,450,0,0,0,468,324,144,0.0
8030,0.2,True,0.02,64,True,vs_right,w,450,76,66,10,392,314,78,0.868421052631579
8030,0.2,True,0.02,64,True,vs_left,w,450,71,69,2,397,322,75,0.971830985915493
8030,0.2,True,0.02,64,True,difference,w,450,2,0,2,466,322,144,0.0
8030,0.2,True,0.02,64,False,baseline,w,1600,1,0,1,1663,1519,144,0.0
8030,0.2,True,0.02,64,False,vs_right,w,1600,189,65,124,1475,1396,79,0.3439153439153439
8030,0.2,True,0.02,64,False,vs_left,w,1600,126,52,74,1538,1446,92,0.4126984126984127
8030,0.2,True,0.02,64,False,difference,w,1600,4,0,4,1660,1516,144,0.0
8030,0.2,True,0.02,31,True,baseline,w,200,0,0,0,208,144,64,0.0
8030,0.2,True,0.02,31,True,vs_right,w,200,32,28,4,176,140,36,0.875
8030,0.2,True,0.02,31,True,vs_left,w,200,31,29,2,177,142,35,0.9354838709677419
8030,0.2,True,0.02,31,True,difference,w,200,2,2,0,206,144,62,1.0
8030,0.2,True,0.02,31,False,baseline,w,775,1,0,1,805,741,64,0.0
8030,0.2,True,0.02,31,False,vs_right,w,775,97,27,70,709,672,37,0.27835051546391754
8030,0.2,True,0.02,31,False,vs_left,w,775,75,28,47,731,695,36,0.37333333333333335
8030,0.2,True,0.02,31,False,difference,w,775,5,0,5,801,737,64,0.0
8030,0.2,True,0.004,86,True,baseline,b,3500,0,0,0,3528,2464,1064,0.0
8030,0.2,True,0.004,86,True,vs_right,b,3500,79,79,0,3449,2464,985,1.0
8030,0.2,True,0.004,86,True,vs_left,b,3500,51,51,0,3477,2464,1013,1.0
8030,0.2,True,0.004,86,True,difference,b,3500,0,0,0,3528,2464,1064,0.0
8030,0.2,True,0.004,86,False,baseline,b,10750,0,0,0,10836,9772,1064,0.0
8030,0.2,True,0.004,86,False,vs_right,b,10750,44,16,28,10792,9744,1048,0.36363636363636365
8030,0.2,True,0.004,86,False,vs_left,b,10750,12,3,9,10824,9763,1061,0.25
8030,0.2,True,0.004,86,False,difference,b,10750,0,0,0,10836,9772,1064,0.0
8030,0.2,True,0.004,64,True,baseline,b,2250,0,0,0,2268,1584,684,0.0
8030,0.2,True,0.004,64,True,vs_right,b,2250,62,62,0,2206,1584,622,1.0
8030,0.2,True,0.004,64,True,vs_left,b,2250,79,79,0,2189,1584,605,1.0
8030,0.2,True,0.004,64,True,difference,b,2250,0,0,0,2268,1584,684,0.0
8030,0.2,True,0.004,64,False,baseline,b,8000,0,0,0,8064,7380,684,0.0
8030,0.2,True,0.004,64,False,vs_right,b,8000,38,21,17,8026,7363,663,0.5526315789473685
8030,0.2,True,0.004,64,False,vs_left,b,8000,21,9,12,8043,7368,675,0.42857142857142855
8030,0.2,True,0.004,64,False,difference,b,8000,0,0,0,8064,7380,684,0.0
8030,0.2,True,0.004,31,True,baseline,b,1000,0,0,0,1008,704,304,0.0
8030,0.2,True,0.004,31,True,vs_right,b,1000,40,40,0,968,704,264,1.0
8030,0.2,True,0.004,31,True,vs_left,b,1000,53,53,0,955,704,251,1.0
8030,0.2,True,0.004,31,True,difference,b,1000,0,0,0,1008,704,304,0.0
8030,0.2,True,0.004,31,False,baseline,b,3875,0,0,0,3906,3602,304,0.0
8030,0.2,True,0.004,31,False,vs_right,b,3875,53,22,31,3853,3571,282,0.41509433962264153
8030,0.2,True,0.004,31,False,vs_left,b,3875,35,12,23,3871,3579,292,0.34285714285714286
8030,0.2,True,0.004,31,False,difference,b,3875,0,0,0,3906,3602,304,0.0
8030,0.2,True,0.012,86,True,baseline,b,1148,0,0,0,1176,840,336,0.0
8030,0.2,True,0.012,86,True,vs_right,b,1148,44,44,0,1132,840,292,1.0
8030,0.2,True,0.012,86,True,vs_left,b,1148,60,60,0,1116,840,276,1.0
8030,0.2,True,0.012,86,True,difference,b,1148,0,0,0,1176,840,336,0.0
8030,0.2,True,0.012,86,False,baseline,b,3526,0,0,0,3612,3276,336,0.0
8030,0.2,True,0.012,86,False,vs_right,b,3526,45,23,22,3567,3254,313,0.5111111111111111
8030,0.2,True,0.012,86,False,vs_left,b,3526,33,15,18,3579,3258,321,0.45454545454545453
8030,0.2,True,0.012,86,False,difference,b,3526,0,0,0,3612,3276,336,0.0
8030,0.2,True,0.012,64,True,baseline,b,738,0,0,0,756,540,216,0.0
8030,0.2,True,0.012,64,True,vs_right,b,738,37,37,0,719,540,179,1.0
8030,0.2,True,0.012,64,True,vs_left,b,738,54,54,0,702,540,162,1.0
8030,0.2,True,0.012,64,True,difference,b,738,0,0,0,756,540,216,0.0
8030,0.2,True,0.012,64,False,baseline,b,2624,0,0,0,2688,2472,216,0.0
8030,0.2,True,0.012,64,False,vs_right,b,2624,42,17,25,2646,2447,199,0.40476190476190477
8030,0.2,True,0.012,64,False,vs_left,b,2624,42,22,20,2646,2452,194,0.5238095238095238
8030,0.2,True,0.012,64,False,difference,b,2624,0,0,0,2688,2472,216,0.0
8030,0.2,True,0.012,31,True,baseline,b,328,0,0,0,336,240,96,0.0
8030,0.2,True,0.012,31,True,vs_right,b,328,18,18,0,318,240,78,1.0
8030,0.2,True,0.012,31,True,vs_left,b,328,24,24,0,312,240,72,1.0
8030,0.2,True,0.012,31,True,difference,b,328,0,0,0,336,240,96,0.0
8030,0.2,True,0.012,31,False,baseline,b,1271,0,0,0,1302,1206,96,0.0
8030,0.2,True,0.012,31,False,vs_right,b,1271,32,12,20,1270,1186,84,0.375
8030,0.2,True,0.012,31,False,vs_left,b,1271,38,17,21,1264,1185,79,0.4473684210526316
8030,0.2,True,0.012,31,False,difference,b,1271,0,0,0,1302,1206,96,0.0
8030,0.2,True,0.02,86,True,baseline,b,700,0,0,0,728,504,224,0.0
8030,0.2,True,0.02,86,True,vs_right,b,700,27,27,0,701,504,197,1.0
8030,0.2,True,0.02,86,True,vs_left,b,700,46,46,0,682,504,178,1.0
8030,0.2,True,0.02,86,True,difference,b,700,0,0,0,728,504,224,0.0
8030,0.2,True,0.02,86,False,baseline,b,2150,0,0,0,2236,2012,224,0.0
8030,0.2,True,0.02,86,False,vs_right,b,2150,47,21,26,2189,1986,203,0.44680851063829785
8030,0.2,True,0.02,86,False,vs_left,b,2150,56,34,22,2180,1990,190,0.6071428571428571
8030,0.2,True,0.02,86,False,difference,b,2150,0,0,0,2236,2012,224,0.0
8030,0.2,True,0.02,64,True,baseline,b,450,0,0,0,468,324,144,0.0
8030,0.2,True,0.02,64,True,vs_right,b,450,23,23,0,445,324,121,1.0
8030,0.2,True,0.02,64,True,vs_left,b,450,34,34,0,434,324,110,1.0
8030,0.2,True,0.02,64,True,difference,b,450,0,0,0,468,324,144,0.0
8030,0.2,True,0.02,64,False,baseline,b,1600,0,0,0,1664,1520,144,0.0
8030,0.2,True,0.02,64,False,vs_right,b,1600,39,16,23,1625,1497,128,0.41025641025641024
8030,0.2,True,0.02,64,False,vs_left,b,1600,55,30,25,1609,1495,114,0.5454545454545454
8030,0.2,True,0.02,64,False,difference,b,1600,0,0,0,1664,1520,144,0.0
8030,0.2,True,0.02,31,True,baseline,b,200,0,0,0,208,144,64,0.0
8030,0.2,True,0.02,31,True,vs_right,b,200,13,13,0,195,144,51,1.0
8030,0.2,True,0.02,31,True,vs_left,b,200,14,14,0,194,144,50,1.0
8030,0.2,True,0.02,31,True,difference,b,200,0,0,0,208,144,64,0.0
8030,0.2,True,0.02,31,False,baseline,b,775,0,0,0,806,742,64,0.0
8030,0.2,True,0.02,31,False,vs_right,b,775,25,7,18,781,724,57,0.28
8030,0.2,True,0.02,31,False,vs_left,b,775,35,14,21,771,721,50,0.4
8030,0.2,True,0.02,31,False,difference,b,775,0,0,0,806,742,64,0.0
8030,0.2,False,0.004,86,True,baseline,w,3500,5,0,5,3523,2459,1064,0.0
8030,0.2,False,0.004,86,True,vs_right,w,3500,523,486,37,3005,2427,578,0.9292543021032504
8030,0.2,False,0.004,86,True,vs_left,w,3500,479,470,9,3049,2455,594,0.9812108559498957
8030,0.2,False,0.004,86,True,difference,w,3500,42,35,7,3486,2457,1029,0.8333333333333334
8030,0.2,False,0.004,86,False,baseline,w,10750,8,0,8,10828,9764,1064,0.0
8030,0.2,False,0.004,86,False,vs_right,w,10750,1176,434,742,9660,9030,630,0.36904761904761907
8030,0.2,False,0.004,86,False,vs_left,w,10750,1138,430,708,9698,9064,634,0.37785588752196836
8030,0.2,False,0.004,86,False,difference,w,10750,42,22,20,10794,9752,1042,0.5238095238095238
8030,0.2,False,0.004,64,True,baseline,w,2250,3,0,3,2265,1581,684,0.0
8030,0.2,False,0.004,64,True,vs_right,w,2250,385,348,37,1883,1547,336,0.9038961038961039
8030,0.2,False,0.004,64,True,vs_left,w,2250,343,334,9,1925,1575,350,0.9737609329446064
8030,0.2,False,0.004,64,True,difference,w,2250,18,18,0,2250,1584,666,1.0
8030,0.2,False,0.004,64,False,baseline,w,8000,6,0,6,8058,7374,684,0.0
8030,0.2,False,0.004,64,False,vs_right,w,8000,922,316,606,7142,6774,368,0.34273318872017355
8030,0.2,False,0.004,64,False,vs_left,w,8000,885,305,580,7179,6800,379,0.3446327683615819
8030,0.2,False,0.004,64,False,difference,w,8000,16,7,9,8048,7371,677,0.4375
8030,0.2,False,0.004,31,True,baseline,w,1000,2,0,2,1006,702,304,0.0
8030,0.2,False,0.004,31,True,vs_right,w,1000,172,151,21,836,683,153,0.877906976744186
8030,0.2,False,0.004,31,True,vs_left,w,1000,155,148,7,853,697,156,0.9548387096774194
8030,0.2,False,0.004,31,True,difference,w,1000,9,7,2,999,702,297,0.7777777777777778
8030,0.2,False,0.004,31,False,baseline,w,3875,7,0,7,3899,3595,304,0.0
8030,0.2,False,0.004,31,False,vs_right,w,3875,458,139,319,3448,3283,165,0.3034934497816594
8030,0.2,False,0.004,31,False,vs_left,w,3875,425,131,294,3481,3308,173,0.30823529411764705
8030,0.2,False,0.004,31,False,difference,w,3875,18,4,14,3888,3588,300,0.2222222222222222
8030,0.2,False,0.012,86,True,baseline,w,1148,0,0,0,1176,840,336,0.0
8030,0.2,False,0.012,86,True,vs_right,w,1148,185,166,19,991,821,170,0.8972972972972973
8030,0.2,False,0.012,86,True,vs_left,w,1148,172,170,2,1004,838,166,0.9883720930232558
8030,0.2,False,0.012,86,True,difference,w,1148,14,14,0,1162,840,322,1.0
8030,0.2,False,0.012,86,False,baseline,w,3526,2,0,2,3610,3274,336,0.0
8030,0.2,False,0.012,86,False,vs_right,w,3526,417,153,264,3195,3012,183,0.3669064748201439
8030,0.2,False,0.012,86,False,vs_left,w,3526,384,146,238,3228,3038,190,0.3802083333333333
8030,0.2,False,0.012,86,False,difference,w,3526,8,6,2,3604,3274,330,0.75
8030,0.2,False,0.012,64,True,baseline,w,738,0,0,0,756,540,216,0.0
8030,0.2,False,0.012,64,True,vs_right,w,738,135,120,15,621,525,96,0.8888888888888888
8030,0.2,False,0.012,64,True,vs_left,w,738,125,123,2,631,538,93,0.984
8030,0.2,False,0.012,64,True,difference,w,738,6,6,0,750,540,210,1.0
8030,0.2,False,0.012,64,False,baseline,w,2624,2,0,2,2686,2470,216,0.0
8030,0.2,False,0.012,64,False,vs_right,w,2624,328,112,216,2360,2256,104,0.34146341463414637
8030,0.2,False,0.012,64,False,vs_left,w,2624,306,103,203,2382,2269,113,0.3366013071895425
8030,0.2,False,0.012,64,False,difference,w,2624,6,4,2,2682,2470,212,0.6666666666666666
8030,0.2,False,0.012,31,True,baseline,w,328,0,0,0,336,240,96,0.0
8030,0.2,False,0.012,31,True,vs_right,w,328,65,50,15,271,225,46,0.7692307692307693
8030,0.2,False,0.012,31,True,vs_left,w,328,56,56,0,280,240,40,1.0
8030,0.2,False,0.012,31,True,difference,w,328,2,2,0,334,240,94,1.0
8030,0.2,False,0.012,31,False,baseline,w,1271,2,0,2,1300,1204,96,0.0
8030,0.2,False,0.012,31,False,vs_right,w,1271,168,46,122,1134,1084,50,0.27380952380952384
8030,0.2,False,0.012,31,False,vs_left,w,1271,152,48,104,1150,1102,48,0.3157894736842105
8030,0.2,False,0.012,31,False,difference,w,1271,6,2,4,1296,1202,94,0.3333333333333333
8030,0.2,False,0.02,86,True,baseline,w,700,0,0,0,728,504,224,0.0
8030,0.2,False,0.02,86,True,vs_right,w,700,97,95,2,631,502,129,0.979381443298969
8030,0.2,False,0.02,86,True,vs_left,w,700,91,91,0,637,504,133,1.0
8030,0.2,False,0.02,86,True,difference,w,700,0,0,0,728,504,224,0.0
8030,0.2,False,0.02,86,False,baseline,w,2150,1,0,1,2235,2011,224,0.0
8030,0.2,False,0.02,86,False,vs_right,w,2150,224,88,136,2012,1876,136,0.39285714285714285
8030,0.2,False,0.02,86,False,vs_left,w,2150,151,70,81,2085,1931,154,0.46357615894039733
8030,0.2,False,0.02,86,False,difference,w,2150,0,0,0,2236,2012,224,0.0
8030,0.2,False,0.02,64,True,baseline,w,450,0,0,0,468,324,144,0.0
8030,0.2,False,0.02,64,True,vs_right,w,450,73,69,4,395,320,75,0.9452054794520548
8030,0.2,False,0.02,64,True,vs_left,w,450,68,68,0,400,324,76,1.0
8030,0.2,False,0.02,64,True,difference,w,450,6,6,0,462,324,138,1.0
8030,0.2,False,0.02,64,False,baseline,w,1600,1,0,1,1663,1519,144,0.0
8030,0.2,False,0.02,64,False,vs_right,w,1600,175,66,109,1489,1411,78,0.37714285714285717
8030,0.2,False,0.02,64,False,vs_left,w,1600,138,57,81,1526,1439,87,0.41304347826086957
8030,0.2,False,0.02,64,False,difference,w,1600,0,0,0,1664,1520,144,0.0
8030,0.2,False,0.02,31,True,baseline,w,200,0,0,0,208,144,64,0.0
8030,0.2,False,0.02,31,True,vs_right,w,200,35,28,7,173,137,36,0.8
8030,0.2,False,0.02,31,True,vs_left,w,200,31,31,0,177,144,33,1.0
8030,0.2,False,0.02,31,True,difference,w,200,2,2,0,206,144,62,1.0
8030,0.2,False,0.02,31,False,baseline,w,775,1,0,1,805,741,64,0.0
8030,0.2,False,0.02,31,False,vs_right,w,775,87,26,61,719,681,38,0.2988505747126437
8030,0.2,False,0.02,31,False,vs_left,w,775,75,26,49,731,693,38,0.3466666666666667
8030,0.2,False,0.02,31,False,difference,w,775,1,0,1,805,741,64,0.0
8030,0.2,False,0.004,86,True,baseline,b,3500,0,0,0,3528,2464,1064,0.0
8030,0.2,False,0.004,86,True,vs_right,b,3500,67,66,1,3461,2463,998,0.9850746268656716
8030,0.2,False,0.004,86,True,vs_left,b,3500,47,46,1,3481,2463,1018,0.9787234042553191
8030,0.2,False,0.004,86,True,difference,b,3500,0,0,0,3528,2464,1064,0.0
8030,0.2,False,0.004,86,False,baseline,b,10750,0,0,0,10836,9772,1064,0.0
8030,0.2,False,0.004,86,False,vs_right,b,10750,59,17,42,10777,9730,1047,0.288135593220339
8030,0.2,False,0.004,86,False,vs_left,b,10750,21,5,16,10815,9756,1059,0.23809523809523808
8030,0.2,False,0.004,86,False,difference,b,10750,0,0,0,10836,9772,1064,0.0
8030,0.2,False,0.004,64,True,baseline,b,2250,0,0,0,2268,1584,684,0.0
8030,0.2,False,0.004,64,True,vs_right,b,2250,66,64,2,2202,1582,620,0.9696969696969697
8030,0.2,False,0.004,64,True,vs_left,b,2250,57,56,1,2211,1583,628,0.9824561403508771
8030,0.2,False,0.004,64,True,difference,b,2250,0,0,0,2268,1584,684,0.0
8030,0.2,False,0.004,64,False,baseline,b,8000,0,0,0,8064,7380,684,0.0
8030,0.2,False,0.004,64,False,vs_right,b,8000,66,24,42,7998,7338,660,0.36363636363636365
8030,0.2,False,0.004,64,False,vs_left,b,8000,27,6,21,8037,7359,678,0.2222222222222222
8030,0.2,False,0.004,64,False,difference,b,8000,0,0,0,8064,7380,684,0.0
8030,0.2,False,0.004,31,True,baseline,b,1000,0,0,0,1008,704,304,0.0
8030,0.2,False,0.004,31,True,vs_right,b,1000,37,37,0,971,704,267,1.0
8030,0.2,False,0.004,31,True,vs_left,b,1000,38,38,0,970,704,266,1.0
8030,0.2,False,0.004,31,True,difference,b,1000,0,0,0,1008,704,304,0.0
8030,0.2,False,0.004,31,False,baseline,b,3875,0,0,0,3906,3602,304,0.0
8030,0.2,False,0.004,31,False,vs_right,b,3875,58,22,36,3848,3566,282,0.3793103448275862
8030,0.2,False,0.004,31,False,vs_left,b,3875,36,12,24,3870,3578,292,0.3333333333333333
8030,0.2,False,0.004,31,False,difference,b,3875,0,0,0,3906,3602,304,0.0
8030,0.2,False,0.012,86,True,baseline,b,1148,0,0,0,1176,840,336,0.0
8030,0.2,False,0.012,86,True,vs_right,b,1148,38,37,1,1138,839,299,0.9736842105263158
8030,0.2,False,0.012,86,True,vs_left,b,1148,47,47,0,1129,840,289,1.0
8030,0.2,False,0.012,86,True,difference,b,1148,0,0,0,1176,840,336,0.0
8030,0.2,False,0.012,86,False,baseline,b,3526,0,0,0,3612,3276,336,0.0
8030,0.2,False,0.012,86,False,vs_right,b,3526,48,19,29,3564,3247,317,0.3958333333333333
8030,0.2,False,0.012,86,False,vs_left,b,3526,28,11,17,3584,3259,325,0.39285714285714285
8030,0.2,False,0.012,86,False,difference,b,3526,0,0,0,3612,3276,336,0.0
8030,0.2,False,0.012,64,True,baseline,b,738,0,0,0,756,540,216,0.0
8030,0.2,False,0.012,64,True,vs_right,b,738,34,33,1,722,539,183,0.9705882352941176
8030,0.2,False,0.012,64,True,vs_left,b,738,47,47,0,709,540,169,1.0
8030,0.2,False,0.012,64,True,difference,b,738,0,0,0,756,540,216,0.0
8030,0.2,False,0.012,64,False,baseline,b,2624,0,0,0,2688,2472,216,0.0
8030,0.2,False,0.012,64,False,vs_right,b,2624,42,15,27,2646,2445,201,0.35714285714285715
8030,0.2,False,0.012,64,False,vs_left,b,2624,32,15,17,2656,2455,201,0.46875
8030,0.2,False,0.012,64,False,difference,b,2624,0,0,0,2688,2472,216,0.0
8030,0.2,False,0.012,31,True,baseline,b,328,0,0,0,336,240,96,0.0
8030,0.2,False,0.012,31,True,vs_right,b,328,17,17,0,319,240,79,1.0
8030,0.2,False,0.012,31,True,vs_left,b,328,23,23,0,313,240,73,1.0
8030,0.2,False,0.012,31,True,difference,b,328,0,0,0,336,240,96,0.0
8030,0.2,False,0.012,31,False,baseline,b,1271,0,0,0,1302,1206,96,0.0
8030,0.2,False,0.012,31,False,vs_right,b,1271,34,12,22,1268,1184,84,0.35294117647058826
8030,0.2,False,0.012,31,False,vs_left,b,1271,26,11,15,1276,1191,85,0.4230769230769231
8030,0.2,False,0.012,31,False,difference,b,1271,0,0,0,1302,1206,96,0.0
8030,0.2,False,0.02,86,True,baseline,b,700,0,0,0,728,504,224,0.0
8030,0.2,False,0.02,86,True,vs_right,b,700,26,25,1,702,503,199,0.9615384615384616
8030,0.2,False,0.02,86,True,vs_left,b,700,41,41,0,687,504,183,1.0
8030,0.2,False,0.02,86,True,difference,b,700,0,0,0,728,504,224,0.0
8030,0.2,False,0.02,86,False,baseline,b,2150,0,0,0,2236,2012,224,0.0
8030,0.2,False,0.02,86,False,vs_right,b,2150,46,20,26,2190,1986,204,0.43478260869565216
8030,0.2,False,0.02,86,False,vs_left,b,2150,48,27,21,2188,1991,197,0.5625
8030,0.2,False,0.02,86,False,difference,b,2150,0,0,0,2236,2012,224,0.0
8030,0.2,False,0.02,64,True,baseline,b,450,0,0,0,468,324,144,0.0
8030,0.2,False,0.02,64,True,vs_right,b,450,27,26,1,441,323,118,0.9629629629629629
8030,0.2,False,0.02,64,True,vs_left,b,450,31,31,0,437,324,113,1.0
8030,0.2,False,0.02,64,True,difference,b,450,0,0,0,468,324,144,0.0
8030,0.2,False,0.02,64,False,baseline,b,1600,0,0,0,1664,1520,144,0.0
8030,0.2,False,0.02,64,False,vs_right,b,1600,40,16,24,1624,1496,128,0.4
8030,0.2,False,0.02,64,False,vs_left,b,1600,41,22,19,1623,1501,122,0.5365853658536586
8030,0.2,False,0.02,64,False,difference,b,1600,0,0,0,1664,1520,144,0.0
8030,0.2,False,0.02,31,True,baseline,b,200,0,0,0,208,144,64,0.0
8030,0.2,False,0.02,31,True,vs_right,b,200,12,12,0,196,144,52,1.0
8030,0.2,False,0.02,31,True,vs_left,b,200,14,14,0,194,144,50,1.0
8030,0.2,False,0.02,31,True,difference,b,200,0,0,0,208,144,64,0.0
8030,0.2,False,0.02,31,False,baseline,b,775,0,0,0,806,742,64,0.0
8030,0.2,False,0.02,31,False,vs_right,b,775,27,8,19,779,723,56,0.2962962962962963
8030,0.2,False,0.02,31,False,vs_left,b,775,26,11,15,780,727,53,0.4230769230769231
8030,0.2,False,0.02,31,False,difference,b,775,0,0,0,806,742,64,0.0
8020,0.1,True,0.004,86,True,baseline,w,3500,10,2,8,3518,2456,1062,0.2
8020,0.1,True,0.004,86,True,vs_right,w,3500,413,382,31,3115,2433,682,0.9249394673123487
8020,0.1,True,0.004,86,True,vs_left,w,3500,434,427,7,3094,2457,637,0.9838709677419355
8020,0.1,True,0.004,86,True,difference,w,3500,30,21,9,3498,2455,1043,0.7
8020,0.1,True,0.004,86,False,baseline,w,10750,23,1,22,10813,9750,1063,0.043478260869565216
8020,0.1,True,0.004,86,False,vs_right,w,10750,794,338,456,10042,9316,726,0.4256926952141058
8020,0.1,True,0.004,86,False,vs_left,w,10750,749,378,371,10087,9401,686,0.5046728971962616
8020,0.1,True,0.004,86,False,difference,w,10750,41,13,28,10795,9744,1051,0.3170731707317073
8020,0.1,True,0.004,64,True,baseline,w,2250,6,0,6,2262,1578,684,0.0
8020,0.1,True,0.004,64,True,vs_right,w,2250,326,300,26,1942,1558,384,0.9202453987730062
8020,0.1,True,0.004,64,True,vs_left,w,2250,313,312,1,1955,1583,372,0.9968051118210862
8020,0.1,True,0.004,64,True,difference,w,2250,23,17,6,2245,1578,667,0.7391304347826086
8020,0.1,True,0.004,64,False,baseline,w,8000,17,0,17,8047,7363,684,0.0
8020,0.1,True,0.004,64,False,vs_right,w,8000,620,256,364,7444,7016,428,0.4129032258064516
8020,0.1,True,0.004,64,False,vs_left,w,8000,564,270,294,7500,7086,414,0.4787234042553192
8020,0.1,True,0.004,64,False,difference,w,8000,26,11,15,8038,7365,673,0.4230769230769231
8020,0.1,True,0.004,31,True,baseline,w,1000,2,0,2,1006,702,304,0.0
8020,0.1,True,0.004,31,True,vs_right,w,1000,148,135,13,860,691,169,0.9121621621621622
8020,0.1,True,0.004,31,True,vs_left,w,1000,139,139,0,869,704,165,1.0
8020,0.1,True,0.004,31,True,difference,w,1000,15,13,2,993,702,291,0.8666666666666667
8020,0.1,True,0.004,31,False,baseline,w,3875,8,0,8,3898,3594,304,0.0
8020,0.1,True,0.004,31,False,vs_right,w,3875,337,126,211,3569,3391,178,0.37388724035608306
8020,0.1,True,0.004,31,False,vs_left,w,3875,278,121,157,3628,3445,183,0.4352517985611511
8020,0.1,True,0.004,31,False,difference,w,3875,16,8,8,3890,3594,296,0.5
8020,0.1,True,0.012,86,True,baseline,w,1148,1,0,1,1175,839,336,0.0
8020,0.1,True,0.012,86,True,vs_right,w,1148,145,135,10,1031,830,201,0.9310344827586207
8020,0.1,True,0.012,86,True,vs_left,w,1148,167,167,0,1009,840,169,1.0
8020,0.1,True,0.012,86,True,difference,w,1148,10,8,2,1166,838,328,0.8
8020,0.1,True,0.012,86,False,baseline,w,3526,7,0,7,3605,3269,336,0.0
8020,0.1,True,0.012,86,False,vs_right,w,3526,281,123,158,3331,3118,213,0.4377224199288256
8020,0.1,True,0.012,86,False,vs_left,w,3526,266,138,128,3346,3148,198,0.518796992481203
8020,0.1,True,0.012,86,False,difference,w,3526,8,4,4,3604,3272,332,0.5
8020,0.1,True,0.012,64,True,baseline,w,738,1,0,1,755,539,216,0.0
8020,0.1,True,0.012,64,True,vs_right,w,738,108,98,10,648,530,118,0.9074074074074074
8020,0.1,True,0.012,64,True,vs_left,w,738,120,119,1,636,539,97,0.9916666666666667
8020,0.1,True,0.012,64,True,difference,w,738,8,6,2,748,538,210,0.75
8020,0.1,True,0.012,64,False,baseline,w,2624,5,0,5,2683,2467,216,0.0
8020,0.1,True,0.012,64,False,vs_right,w,2624,215,92,123,2473,2349,124,0.42790697674418604
8020,0.1,True,0.012,64,False,vs_left,w,2624,198,100,98,2490,2374,116,0.5050505050505051
8020,0.1,True,0.012,64,False,difference,w,2624,6,4,2,2682,2470,212,0.6666666666666666
8020,0.1,True,0.012,31,True,baseline,w,328,1,0,1,335,239,96,0.0
8020,0.1,True,0.012,31,True,vs_right,w,328,53,49,4,283,236,47,0.9245283018867925
8020,0.1,True,0.012,31,True,vs_left,w,328,51,51,0,285,240,45,1.0
8020,0.1,True,0.012,31,True,difference,w,328,4,4,0,332,240,92,1.0
8020,0.1,True,0.012,31,False,baseline,w,1271,1,0,1,1301,1205,96,0.0
8020,0.1,True,0.012,31,False,vs_right,w,1271,118,44,74,1184,1132,52,0.3728813559322034
8020,0.1,True,0.012,31,False,vs_left,w,1271,101,47,54,1201,1152,49,0.46534653465346537
8020,0.1,True,0.012,31,False,difference,w,1271,6,4,2,1296,1204,92,0.6666666666666666
8020,0.1,True,0.02,86,True,baseline,w,700,1,0,1,727,503,224,0.0
8020,0.1,True,0.02,86,True,vs_right,w,700,74,70,4,654,500,154,0.9459459459459459
8020,0.1,True,0.02,86,True,vs_left,w,700,80,80,0,648,504,144,1.0
8020,0.1,True,0.02,86,True,difference,w,700,6,4,2,722,502,220,0.6666666666666666
8020,0.1,True,0.02,86,False,baseline,w,2150,0,0,0,2236,2012,224,0.0
8020,0.1,True,0.02,86,False,vs_right,w,2150,126,59,67,2110,1945,165,0.46825396825396826
8020,0.1,True,0.02,86,False,vs_left,w,2150,89,59,30,2147,1982,165,0.6629213483146067
8020,0.1,True,0.02,86,False,difference,w,2150,2,2,0,2234,2012,222,1.0
8020,0.1,True,0.02,64,True,baseline,w,450,1,0,1,467,323,144,0.0
8020,0.1,True,0.02,64,True,vs_right,w,450,51,47,4,417,320,97,0.9215686274509803
8020,0.1,True,0.02,64,True,vs_left,w,450,61,61,0,407,324,83,1.0
8020,0.1,True,0.02,64,True,difference,w,450,4,2,2,464,322,142,0.5
8020,0.1,True,0.02,64,False,baseline,w,1600,0,0,0,1664,1520,144,0.0
8020,0.1,True,0.02,64,False,vs_right,w,1600,92,40,52,1572,1468,104,0.43478260869565216
8020,0.1,True,0.02,64,False,vs_left,w,1600,70,43,27,1594,1493,101,0.6142857142857143
8020,0.1,True,0.02,64,False,difference,w,1600,2,2,0,1662,1520,142,1.0
8020,0.1,True,0.02,31,True,baseline,w,200,1,0,1,207,143,64,0.0
8020,0.1,True,0.02,31,True,vs_right,w,200,25,23,2,183,142,41,0.92
8020,0.1,True,0.02,31,True,vs_left,w,200,32,32,0,176,144,32,1.0
8020,0.1,True,0.02,31,True,difference,w,200,2,2,0,206,144,62,1.0
8020,0.1,True,0.02,31,False,baseline,w,775,1,0,1,805,741,64,0.0
8020,0.1,True,0.02,31,False,vs_right,w,775,52,20,32,754,710,44,0.38461538461538464
8020,0.1,True,0.02,31,False,vs_left,w,775,41,24,17,765,725,40,0.5853658536585366
8020,0.1,True,0.02,31,False,difference,w,775,2,2,0,804,742,62,1.0
8020,0.1,True,0.004,86,True,baseline,b,3500,0,0,0,3528,2464,1064,0.0
8020,0.1,True,0.004,86,True,vs_right,b,3500,53,52,1,3475,2463,1012,0.9811320754716981
8020,0.1,True,0.004,86,True,vs_left,b,3500,33,33,0,3495,2464,1031,1.0
8020,0.1,True,0.004,86,True,difference,b,3500,0,0,0,3528,2464,1064,0.0
8020,0.1,True,0.004,86,False,baseline,b,10750,0,0,0,10836,9772,1064,0.0
8020,0.1,True,0.004,86,False,vs_right,b,10750,21,14,7,10815,9765,1050,0.6666666666666666
8020,0.1,True,0.004,86,False,vs_left,b,10750,11,8,3,10825,9769,1056,0.7272727272727273
8020,0.1,True,0.004,86,False,difference,b,10750,0,0,0,10836,9772,1064,0.0
8020,0.1,True,0.004,64,True,baseline,b,2250,0,0,0,2268,1584,684,0.0
8020,0.1,True,0.004,64,True,vs_right,b,2250,50,48,2,2218,1582,636,0.96
8020,0.1,True,0.004,64,True,vs_left,b,2250,32,32,0,2236,1584,652,1.0
8020,0.1,True,0.004,64,True,difference,b,2250,0,0,0,2268,1584,684,0.0
8020,0.1,True,0.004,64,False,baseline,b,8000,0,0,0,8064,7380,684,0.0
8020,0.1,True,0.004,64,False,vs_right,b,8000,33,20,13,8031,7367,664,0.6060606060606061
8020,0.1,True,0.004,64,False,vs_left,b,8000,9,6,3,8055,7377,678,0.6666666666666666
8020,0.1,True,0.004,64,False,difference,b,8000,0,0,0,8064,7380,684,0.0
8020,0.1,True,0.004,31,True,baseline,b,1000,0,0,0,1008,704,304,0.0
8020,0.1,True,0.004,31,True,vs_right,b,1000,36,36,0,972,704,268,1.0
8020,0.1,True,0.004,31,True,vs_left,b,1000,29,29,0,979,704,275,1.0
8020,0.1,True,0.004,31,True,difference,b,1000,1,1,0,1007,704,303,1.0
8020,0.1,True,0.004,31,False,baseline,b,3875,0,0,0,3906,3602,304,0.0
8020,0.1,True,0.004,31,False,vs_right,b,3875,25,14,11,3881,3591,290,0.56
8020,0.1,True,0.004,31,False,vs_left,b,3875,6,6,0,3900,3602,298,1.0
8020,0.1,True,0.004,31,False,difference,b,3875,0,0,0,3906,3602,304,0.0
8020,0.1,True,0.012,86,True,baseline,b,1148,0,0,0,1176,840,336,0.0
8020,0.1,True,0.012,86,True,vs_right,b,1148,31,31,0,1145,840,305,1.0
8020,0.1,True,0.012,86,True,vs_left,b,1148,31,31,0,1145,840,305,1.0
8020,0.1,True,0.012,86,True,difference,b,1148,0,0,0,1176,840,336,0.0
8020,0.1,True,0.012,86,False,baseline,b,3526,0,0,0,3612,3276,336,0.0
8020,0.1,True,0.012,86,False,vs_right,b,3526,25,17,8,3587,3268,319,0.68
8020,0.1,True,0.012,86,False,vs_left,b,3526,15,11,4,3597,3272,325,0.7333333333333333
8020,0.1,True,0.012,86,False,difference,b,3526,0,0,0,3612,3276,336,0.0
8020,0.1,True,0.012,64,True,baseline,b,738,0,0,0,756,540,216,0.0
8020,0.1,True,0.012,64,True,vs_right,b,738,28,27,1,728,539,189,0.9642857142857143
8020,0.1,True,0.012,64,True,vs_left,b,738,30,30,0,726,540,186,1.0
8020,0.1,True,0.012,64,True,difference,b,738,0,0,0,756,540,216,0.0
8020,0.1,True,0.012,64,False,baseline,b,2624,0,0,0,2688,2472,216,0.0
8020,0.1,True,0.012,64,False,vs_right,b,2624,23,15,8,2665,2464,201,0.6521739130434783
8020,0.1,True,0.012,64,False,vs_left,b,2624,13,7,6,2675,2466,209,0.5384615384615384
8020,0.1,True,0.012,64,False,difference,b,2624,0,0,0,2688,2472,216,0.0
8020,0.1,True,0.012,31,True,baseline,b,328,0,0,0,336,240,96,0.0
8020,0.1,True,0.012,31,True,vs_right,b,328,14,14,0,322,240,82,1.0
8020,0.1,True,0.012,31,True,vs_left,b,328,18,18,0,318,240,78,1.0
8020,0.1,True,0.012,31,True,difference,b,328,1,1,0,335,240,95,1.0
8020,0.1,True,0.012,31,False,baseline,b,1271,0,0,0,1302,1206,96,0.0
8020,0.1,True,0.012,31,False,vs_right,b,1271,14,9,5,1288,1201,87,0.6428571428571429
8020,0.1,True,0.012,31,False,vs_left,b,1271,12,9,3,1290,1203,87,0.75
8020,0.1,True,0.012,31,False,difference,b,1271,0,0,0,1302,1206,96,0.0
8020,0.1,True,0.02,86,True,baseline,b,700,0,0,0,728,504,224,0.0
8020,0.1,True,0.02,86,True,vs_right,b,700,28,28,0,700,504,196,1.0
8020,0.1,True,0.02,86,True,vs_left,b,700,33,33,0,695,504,191,1.0
8020,0.1,True,0.02,86,True,difference,b,700,0,0,0,728,504,224,0.0
8020,0.1,True,0.02,86,False,baseline,b,2150,0,0,0,2236,2012,224,0.0
8020,0.1,True,0.02,86,False,vs_right,b,2150,25,18,7,2211,2005,206,0.72
8020,0.1,True,0.02,86,False,vs_left,b,2150,25,18,7,2211,2005,206,0.72
8020,0.1,True,0.02,86,False,difference,b,2150,0,0,0,2236,2012,224,0.0
8020,0.1,True,0.02,64,True,baseline,b,450,0,0,0,468,324,144,0.0
8020,0.1,True,0.02,64,True,vs_right,b,450,23,23,0,445,324,121,1.0
8020,0.1,True,0.02,64,True,vs_left,b,450,25,25,0,443,324,119,1.0
8020,0.1,True,0.02,64,True,difference,b,450,0,0,0,468,324,144,0.0
8020,0.1,True,0.02,64,False,baseline,b,1600,0,0,0,1664,1520,144,0.0
8020,0.1,True,0.02,64,False,vs_right,b,1600,22,15,7,1642,1513,129,0.6818181818181818
8020,0.1,True,0.02,64,False,vs_left,b,1600,20,15,5,1644,1515,129,0.75
8020,0.1,True,0.02,64,False,difference,b,1600,0,0,0,1664,1520,144,0.0
8020,0.1,True,0.02,31,True,baseline,b,200,0,0,0,208,144,64,0.0
8020,0.1,True,0.02,31,True,vs_right,b,200,12,12,0,196,144,52,1.0
8020,0.1,True,0.02,31,True,vs_left,b,200,11,11,0,197,144,53,1.0
8020,0.1,True,0.02,31,True,difference,b,200,0,0,0,208,144,64,0.0
8020,0.1,True,0.02,31,False,baseline,b,775,0,0,0,806,742,64,0.0
8020,0.1,True,0.02,31,False,vs_right,b,775,12,8,4,794,738,56,0.6666666666666666
8020,0.1,True,0.02,31,False,vs_left,b,775,12,9,3,794,739,55,0.75
8020,0.1,True,0.02,31,False,difference,b,775,0,0,0,806,742,64,0.0
8020,0.1,False,0.004,86,True,baseline,w,3500,2,0,2,3526,2462,1064,0.0
8020,0.1,False,0.004,86,True,vs_right,w,3500,403,386,17,3125,2447,678,0.9578163771712159
8020,0.1,False,0.004,86,True,vs_left,w,3500,415,403,12,3113,2452,661,0.9710843373493976
8020,0.1,False,0.004,86,True,difference,w,3500,22,13,9,3506,2455,1051,0.5909090909090909
8020,0.1,False,0.004,86,False,baseline,w,10750,6,0,6,10830,9766,1064,0.0
8020,0.1,False,0.004,86,False,vs_right,w,10750,670,333,337,10166,9435,731,0.49701492537313435
8020,0.1,False,0.004,86,False,vs_left,w,10750,618,359,259,10218,9513,705,0.580906148867314
8020,0.1,False,0.004,86,False,difference,w,10750,29,11,18,10807,9754,1053,0.3793103448275862
8020,0.1,False,0.004,64,True,baseline,w,2250,0,0,0,2268,1584,684,0.0
8020,0.1,False,0.004,64,True,vs_right,w,2250,313,303,10,1955,1574,381,0.9680511182108626
8020,0.1,False,0.004,64,True,vs_left,w,2250,311,302,9,1957,1575,382,0.9710610932475884
8020,0.1,False,0.004,64,True,difference,w,2250,19,16,3,2249,1581,668,0.8421052631578947
8020,0.1,False,0.004,64,False,baseline,w,8000,4,0,4,8060,7376,684,0.0
8020,0.1,False,0.004,64,False,vs_right,w,8000,526,259,267,7538,7113,425,0.4923954372623574
8020,0.1,False,0.004,64,False,vs_left,w,8000,499,275,224,7565,7156,409,0.5511022044088176
8020,0.1,False,0.004,64,False,difference,w,8000,23,10,13,8041,7367,674,0.43478260869565216
8020,0.1,False,0.004,31,True,baseline,w,1000,2,0,2,1006,702,304,0.0
8020,0.1,False,0.004,31,True,vs_right,w,1000,143,133,10,865,694,171,0.9300699300699301
8020,0.1,False,0.004,31,True,vs_left,w,1000,139,128,11,869,693,176,0.920863309352518
8020,0.1,False,0.004,31,True,difference,w,1000,14,14,0,994,704,290,1.0
8020,0.1,False,0.004,31,False,baseline,w,3875,3,0,3,3903,3599,304,0.0
8020,0.1,False,0.004,31,False,vs_right,w,3875,267,119,148,3639,3454,185,0.44569288389513106
8020,0.1,False,0.004,31,False,vs_left,w,3875,232,114,118,3674,3484,190,0.49137931034482757
8020,0.1,False,0.004,31,False,difference,w,3875,18,7,11,3888,3591,297,0.3888888888888889
8020,0.1,False,0.012,86,True,baseline,w,1148,0,0,0,1176,840,336,0.0
8020,0.1,False,0.012,86,True,vs_right,w,1148,144,141,3,1032,837,195,0.9791666666666666
8020,0.1,False,0.012,86,True,vs_left,w,1148,148,148,0,1028,840,188,1.0
8020,0.1,False,0.012,86,True,difference,w,1148,8,6,2,1168,838,330,0.75
8020,0.1,False,0.012,86,False,baseline,w,3526,4,0,4,3608,3272,336,0.0
8020,0.1,False,0.012,86,False,vs_right,w,3526,242,130,112,3370,3164,206,0.5371900826446281
8020,0.1,False,0.012,86,False,vs_left,w,3526,206,129,77,3406,3199,207,0.6262135922330098
8020,0.1,False,0.012,86,False,difference,w,3526,4,4,0,3608,3276,332,1.0
8020,0.1,False,0.012,64,True,baseline,w,738,0,0,0,756,540,216,0.0
8020,0.1,False,0.012,64,True,vs_right,w,738,111,109,2,645,538,107,0.9819819819819819
8020,0.1,False,0.012,64,True,vs_left,w,738,112,112,0,644,540,104,1.0
8020,0.1,False,0.012,64,True,difference,w,738,9,9,0,747,540,207,1.0
8020,0.1,False,0.012,64,False,baseline,w,2624,4,0,4,2684,2468,216,0.0
8020,0.1,False,0.012,64,False,vs_right,w,2624,182,100,82,2506,2390,116,0.5494505494505495
8020,0.1,False,0.012,64,False,vs_left,w,2624,168,97,71,2520,2401,119,0.5773809523809523
8020,0.1,False,0.012,64,False,difference,w,2624,6,6,0,2682,2472,210,1.0
8020,0.1,False,0.012,31,True,baseline,w,328,0,0,0,336,240,96,0.0
8020,0.1,False,0.012,31,True,vs_right,w,328,50,45,5,286,235,51,0.9
8020,0.1,False,0.012,31,True,vs_left,w,328,44,44,0,292,240,52,1.0
8020,0.1,False,0.012,31,True,difference,w,328,7,7,0,329,240,89,1.0
8020,0.1,False,0.012,31,False,baseline,w,1271,4,0,4,1298,1202,96,0.0
8020,0.1,False,0.012,31,False,vs_right,w,1271,102,43,59,1200,1147,53,0.4215686274509804
8020,0.1,False,0.012,31,False,vs_left,w,1271,84,41,43,1218,1163,55,0.4880952380952381
8020,0.1,False,0.012,31,False,difference,w,1271,4,4,0,1298,1206,92,1.0
8020,0.1,False,0.02,86,True,baseline,w,700,0,0,0,728,504,224,0.0
8020,0.1,False,0.02,86,True,vs_right,w,700,84,80,4,644,500,144,0.9523809523809523
8020,0.1,False,0.02,86,True,vs_left,w,700,76,76,0,652,504,148,1.0
8020,0.1,False,0.02,86,True,difference,w,700,2,2,0,726,504,222,1.0
8020,0.1,False,0.02,86,False,baseline,w,2150,2,0,2,2234,2010,224,0.0
8020,0.1,False,0.02,86,False,vs_right,w,2150,119,68,51,2117,1961,156,0.5714285714285714
8020,0.1,False,0.02,86,False,vs_left,w,2150,80,54,26,2156,1986,170,0.675
8020,0.1,False,0.02,86,False,difference,w,2150,0,0,0,2236,2012,224,0.0
8020,0.1,False,0.02,64,True,baseline,w,450,0,0,0,468,324,144,0.0
8020,0.1,False,0.02,64,True,vs_right,w,450,61,59,2,407,322,85,0.9672131147540983
8020,0.1,False,0.02,64,True,vs_left,w,450,59,59,0,409,324,85,1.0
8020,0.1,False,0.02,64,True,difference,w,450,2,2,0,466,324,142,1.0
8020,0.1,False,0.02,64,False,baseline,w,1600,2,0,2,1662,1518,144,0.0
8020,0.1,False,0.02,64,False,vs_right,w,1600,97,52,45,1567,1475,92,0.5360824742268041
8020,0.1,False,0.02,64,False,vs_left,w,1600,69,43,26,1595,1494,101,0.6231884057971014
8020,0.1,False,0.02,64,False,difference,w,1600,0,0,0,1664,1520,144,0.0
8020,0.1,False,0.02,31,True,baseline,w,200,0,0,0,208,144,64,0.0
8020,0.1,False,0.02,31,True,vs_right,w,200,23,21,2,185,142,43,0.9130434782608695
8020,0.1,False,0.02,31,True,vs_left,w,200,27,25,2,181,142,39,0.9259259259259259
8020,0.1,False,0.02,31,True,difference,w,200,4,4,0,204,144,60,1.0
8020,0.1,False,0.02,31,False,baseline,w,775,2,0,2,804,740,64,0.0
8020,0.1,False,0.02,31,False,vs_right,w,775,48,21,27,758,715,43,0.4375
8020,0.1,False,0.02,31,False,vs_left,w,775,33,17,16,773,726,47,0.5151515151515151
8020,0.1,False,0.02,31,False,difference,w,775,2,2,0,804,742,62,1.0
8020,0.1,False,0.004,86,True,baseline,b,3500,0,0,0,3528,2464,1064,0.0
8020,0.1,False,0.004,86,True,vs_right,b,3500,47,47,0,3481,2464,1017,1.0
8020,0.1,False,0.004,86,True,vs_left,b,3500,37,37,0,3491,2464,1027,1.0
8020,0.1,False,0.004,86,True,difference,b,3500,0,0,0,3528,2464,1064,0.0
8020,0.1,False,0.004,86,False,baseline,b,10750,0,0,0,10836,9772,1064,0.0
8020,0.1,False,0.004,86,False,vs_right,b,10750,28,17,11,10808,9761,1047,0.6071428571428571
8020,0.1,False,0.004,86,False,vs_left,b,10750,6,2,4,10830,9768,1062,0.3333333333333333
8020,0.1,False,0.004,86,False,difference,b,10750,0,0,0,10836,9772,1064,0.0
8020,0.1,False,0.004,64,True,baseline,b,2250,0,0,0,2268,1584,684,0.0
8020,0.1,False,0.004,64,True,vs_right,b,2250,53,53,0,2215,1584,631,1.0
8020,0.1,False,0.004,64,True,vs_left,b,2250,34,34,0,2234,1584,650,1.0
8020,0.1,False,0.004,64,True,difference,b,2250,0,0,0,2268,1584,684,0.0
8020,0.1,False,0.004,64,False,baseline,b,8000,0,0,0,8064,7380,684,0.0
8020,0.1,False,0.004,64,False,vs_right,b,8000,29,21,8,8035,7372,663,0.7241379310344828
8020,0.1,False,0.004,64,False,vs_left,b,8000,10,5,5,8054,7375,679,0.5
8020,0.1,False,0.004,64,False,difference,b,8000,0,0,0,8064,7380,684,0.0
8020,0.1,False,0.004,31,True,baseline,b,1000,0,0,0,1008,704,304,0.0
8020,0.1,False,0.004,31,True,vs_right,b,1000,33,33,0,975,704,271,1.0
8020,0.1,False,0.004,31,True,vs_left,b,1000,24,24,0,984,704,280,1.0
8020,0.1,False,0.004,31,True,difference,b,1000,0,0,0,1008,704,304,0.0
8020,0.1,False,0.004,31,False,baseline,b,3875,0,0,0,3906,3602,304,0.0
8020,0.1,False,0.004,31,False,vs_right,b,3875,26,18,8,3880,3594,286,0.6923076923076923
8020,0.1,False,0.004,31,False,vs_left,b,3875,14,10,4,3892,3598,294,0.7142857142857143
8020,0.1,False,0.004,31,False,difference,b,3875,0,0,0,3906,3602,304,0.0
8020,0.1,False,0.012,86,True,baseline,b,1148,0,0,0,1176,840,336,0.0
8020,0.1,False,0.012,86,True,vs_right,b,1148,30,30,0,1146,840,306,1.0
8020,0.1,False,0.012,86,True,vs_left,b,1148,29,29,0,1147,840,307,1.0
8020,0.1,False,0.012,86,True,difference,b,1148,1,0,1,1175,839,336,0.0
8020,0.1,False,0.012,86,False,baseline,b,3526,0,0,0,3612,3276,336,0.0
8020,0.1,False,0.012,86,False,vs_right,b,3526,20,13,7,3592,3269,323,0.65
8020,0.1,False,0.012,86,False,vs_left,b,3526,16,10,6,3596,3270,326,0.625
8020,0.1,False,0.012,86,False,difference,b,3526,0,0,0,3612,3276,336,0.0
8020,0.1,False,0.012,64,True,baseline,b,738,0,0,0,756,540,216,0.0
8020,0.1,False,0.012,64,True,vs_right,b,738,24,24,0,732,540,192,1.0
8020,0.1,False,0.012,64,True,vs_left,b,738,28,28,0,728,540,188,1.0
8020,0.1,False,0.012,64,True,difference,b,738,0,0,0,756,540,216,0.0
8020,0.1,False,0.012,64,False,baseline,b,2624,0,0,0,2688,2472,216,0.0
8020,0.1,False,0.012,64,False,vs_right,b,2624,19,14,5,2669,2467,202,0.7368421052631579
8020,0.1,False,0.012,64,False,vs_left,b,2624,15,10,5,2673,2467,206,0.6666666666666666
8020,0.1,False,0.012,64,False,difference,b,2624,0,0,0,2688,2472,216,0.0
8020,0.1,False,0.012,31,True,baseline,b,328,0,0,0,336,240,96,0.0
8020,0.1,False,0.012,31,True,vs_right,b,328,13,13,0,323,240,83,1.0
8020,0.1,False,0.012,31,True,vs_left,b,328,11,11,0,325,240,85,1.0
8020,0.1,False,0.012,31,True,difference,b,328,0,0,0,336,240,96,0.0
8020,0.1,False,0.012,31,False,baseline,b,1271,0,0,0,1302,1206,96,0.0
8020,0.1,False,0.012,31,False,vs_right,b,1271,13,9,4,1289,1202,87,0.6923076923076923
8020,0.1,False,0.012,31,False,vs_left,b,1271,9,6,3,1293,1203,90,0.6666666666666666
8020,0.1,False,0.012,31,False,difference,b,1271,1,0,1,1301,1205,96,0.0
8020,0.1,False,0.02,86,True,baseline,b,700,0,0,0,728,504,224,0.0
8020,0.1,False,0.02,86,True,vs_right,b,700,24,24,0,704,504,200,1.0
8020,0.1,False,0.02,86,True,vs_left,b,700,30,30,0,698,504,194,1.0
8020,0.1,False,0.02,86,True,difference,b,700,0,0,0,728,504,224,0.0
8020,0.1,False,0.02,86,False,baseline,b,2150,0,0,0,2236,2012,224,0.0
8020,0.1,False,0.02,86,False,vs_right,b,2150,19,14,5,2217,2007,210,0.7368421052631579
8020,0.1,False,0.02,86,False,vs_left,b,2150,20,16,4,2216,2008,208,0.8
8020,0.1,False,0.02,86,False,difference,b,2150,0,0,0,2236,2012,224,0.0
8020,0.1,False,0.02,64,True,baseline,b,450,0,0,0,468,324,144,0.0
8020,0.1,False,0.02,64,True,vs_right,b,450,21,21,0,447,324,123,1.0
8020,0.1,False,0.02,64,True,vs_left,b,450,24,24,0,444,324,120,1.0
8020,0.1,False,0.02,64,True,difference,b,450,0,0,0,468,324,144,0.0
8020,0.1,False,0.02,64,False,baseline,b,1600,0,0,0,1664,1520,144,0.0
8020,0.1,False,0.02,64,False,vs_right,b,1600,17,12,5,1647,1515,132,0.7058823529411765
8020,0.1,False,0.02,64,False,vs_left,b,1600,16,12,4,1648,1516,132,0.75
8020,0.1,False,0.02,64,False,difference,b,1600,0,0,0,1664,1520,144,0.0
8020,0.1,False,0.02,31,True,baseline,b,200,0,0,0,208,144,64,0.0
8020,0.1,False,0.02,31,True,vs_right,b,200,11,11,0,197,144,53,1.0
8020,0.1,False,0.02,31,True,vs_left,b,200,9,9,0,199,144,55,1.0
8020,0.1,False,0.02,31,True,difference,b,200,0,0,0,208,144,64,0.0
8020,0.1,False,0.02,31,False,baseline,b,775,0,0,0,806,742,64,0.0
8020,0.1,False,0.02,31,False,vs_right,b,775,13,9,4,793,738,55,0.6923076923076923
8020,0.1,False,0.02,31,False,vs_left,b,775,14,8,6,792,736,56,0.5714285714285714
8020,0.1,False,0.02,31,False,difference,b,775,0,0,0,806,742,64,0.0
8020,0.2,True,0.004,86,True,baseline,w,3500,13,9,4,3515,2460,1055,0.6923076923076923
8020,0.2,True,0.004,86,True,vs_right,w,3500,513,475,38,3015,2426,589,0.9259259259259259
8020,0.2,True,0.004,86,True,vs_left,w,3500,486,472,14,3042,2450,592,0.9711934156378601
8020,0.2,True,0.004,86,True,difference,w,3500,51,40,11,3477,2453,1024,0.7843137254901961
8020,0.2,True,0.004,86,False,baseline,w,10750,27,5,22,10809,9750,1059,0.18518518518518517
8020,0.2,True,0.004,86,False,vs_right,w,10750,1171,432,739,9665,9033,632,0.36891545687446625
8020,0.2,True,0.004,86,False,vs_left,w,10750,1128,430,698,9708,9074,634,0.38120567375886527
8020,0.2,True,0.004,86,False,difference,w,10750,66,22,44,10770,9728,1042,0.3333333333333333
8020,0.2,True,0.004,64,True,baseline,w,2250,11,7,4,2257,1580,677,0.6363636363636364
8020,0.2,True,0.004,64,True,vs_right,w,2250,367,339,28,1901,1556,345,0.9237057220708447
8020,0.2,True,0.004,64,True,vs_left,w,2250,335,326,9,1933,1575,358,0.9731343283582089
8020,0.2,True,0.004,64,True,difference,w,2250,34,23,11,2234,1573,661,0.6764705882352942
8020,0.2,True,0.004,64,False,baseline,w,8000,28,5,23,8036,7357,679,0.17857142857142858
8020,0.2,True,0.004,64,False,vs_right,w,8000,892,306,586,7172,6794,378,0.3430493273542601
8020,0.2,True,0.004,64,False,vs_left,w,8000,851,303,548,7213,6832,381,0.35605170387779084
8020,0.2,True,0.004,64,False,difference,w,8000,49,13,36,8015,7344,671,0.2653061224489796
8020,0.2,True,0.004,31,True,baseline,w,1000,0,0,0,1008,704,304,0.0
8020,0.2,True,0.004,31,True,vs_right,w,1000,184,154,30,824,674,150,0.8369565217391305
8020,0.2,True,0.004,31,True,vs_left,w,1000,154,146,8,854,696,158,0.948051948051948
8020,0.2,True,0.004,31,True,difference,w,1000,22,18,4,986,700,286,0.8181818181818182
8020,0.2,True,0.004,31,False,baseline,w,3875,9,0,9,3897,3593,304,0.0
8020,0.2,True,0.004,31,False,vs_right,w,3875,464,138,326,3442,3276,166,0.2974137931034483
8020,0.2,True,0.004,31,False,vs_left,w,3875,424,129,295,3482,3307,175,0.30424528301886794
8020,0.2,True,0.004,31,False,difference,w,3875,32,7,25,3874,3577,297,0.21875
8020,0.2,True,0.012,86,True,baseline,w,1148,0,0,0,1176,840,336,0.0
8020,0.2,True,0.012,86,True,vs_right,w,1148,184,162,22,992,818,174,0.8804347826086957
8020,0.2,True,0.012,86,True,vs_left,w,1148,182,178,4,994,836,158,0.978021978021978
8020,0.2,True,0.012,86,True,difference,w,1148,20,16,4,1156,836,320,0.8
8020,0.2,True,0.012,86,False,baseline,w,3526,2,0,2,3610,3274,336,0.0
8020,0.2,True,0.012,86,False,vs_right,w,3526,417,158,259,3195,3017,178,0.37889688249400477
8020,0.2,True,0.012,86,False,vs_left,w,3526,408,153,255,3204,3021,183,0.375
8020,0.2,True,0.012,86,False,difference,w,3526,19,8,11,3593,3265,328,0.42105263157894735
8020,0.2,True,0.012,64,True,baseline,w,738,0,0,0,756,540,216,0.0
8020,0.2,True,0.012,64,True,vs_right,w,738,132,116,16,624,524,100,0.8787878787878788
8020,0.2,True,0.012,64,True,vs_left,w,738,124,122,2,632,538,94,0.9838709677419355
8020,0.2,True,0.012,64,True,difference,w,738,12,10,2,744,538,206,0.8333333333333334
8020,0.2,True,0.012,64,False,baseline,w,2624,2,0,2,2686,2470,216,0.0
8020,0.2,True,0.012,64,False,vs_right,w,2624,317,112,205,2371,2267,104,0.35331230283911674
8020,0.2,True,0.012,64,False,vs_left,w,2624,303,103,200,2385,2272,113,0.33993399339933994
8020,0.2,True,0.012,64,False,difference,w,2624,11,2,9,2677,2463,214,0.18181818181818182
8020,0.2,True,0.012,31,True,baseline,w,328,0,0,0,336,240,96,0.0
8020,0.2,True,0.012,31,True,vs_right,w,328,65,51,14,271,226,45,0.7846153846153846
8020,0.2,True,0.012,31,True,vs_left,w,328,55,52,3,281,237,44,0.9454545454545454
8020,0.2,True,0.012,31,True,difference,w,328,8,6,2,328,238,90,0.75
8020,0.2,True,0.012,31,False,baseline,w,1271,0,0,0,1302,1206,96,0.0
8020,0.2,True,0.012,31,False,vs_right,w,1271,172,48,124,1130,1082,48,0.27906976744186046
8020,0.2,True,0.012,31,False,vs_left,w,1271,155,49,106,1147,1100,47,0.3161290322580645
8020,0.2,True,0.012,31,False,difference,w,1271,10,2,8,1292,1198,94,0.2
8020,0.2,True,0.02,86,True,baseline,w,700,0,0,0,728,504,224,0.0
8020,0.2,True,0.02,86,True,vs_right,w,700,100,90,10,628,494,134,0.9
8020,0.2,True,0.02,86,True,vs_left,w,700,93,91,2,635,502,133,0.978494623655914
8020,0.2,True,0.02,86,True,difference,w,700,9,9,0,719,504,215,1.0
8020,0.2,True,0.02,86,False,baseline,w,2150,0,0,0,2236,2012,224,0.0
8020,0.2,True,0.02,86,False,vs_right,w,2150,226,87,139,2010,1873,137,0.38495575221238937
8020,0.2,True,0.02,86,False,vs_left,w,2150,165,75,90,2071,1922,149,0.45454545454545453
8020,0.2,True,0.02,86,False,difference,w,2150,4,2,2,2232,2010,222,0.5
8020,0.2,True,0.02,64,True,baseline,w,450,0,0,0,468,324,144,0.0
8020,0.2,True,0.02,64,True,vs_right,w,450,72,66,6,396,318,78,0.9166666666666666
8020,0.2,True,0.02,64,True,vs_left,w,450,66,64,2,402,322,80,0.9696969696969697
8020,0.2,True,0.02,64,True,difference,w,450,2,2,0,466,324,142,1.0
8020,0.2,True,0.02,64,False,baseline,w,1600,0,0,0,1664,1520,144,0.0
8020,0.2,True,0.02,64,False,vs_right,w,1600,175,62,113,1489,1407,82,0.35428571428571426
8020,0.2,True,0.02,64,False,vs_left,w,1600,130,56,74,1534,1446,88,0.4307692307692308
8020,0.2,True,0.02,64,False,difference,w,1600,4,2,2,1660,1518,142,0.5
8020,0.2,True,0.02,31,True,baseline,w,200,0,0,0,208,144,64,0.0
8020,0.2,True,0.02,31,True,vs_right,w,200,35,29,6,173,138,35,0.8285714285714286
8020,0.2,True,0.02,31,True,vs_left,w,200,33,31,2,175,142,33,0.9393939393939394
8020,0.2,True,0.02,31,True,difference,w,200,4,4,0,204,144,60,1.0
8020,0.2,True,0.02,31,False,baseline,w,775,0,0,0,806,742,64,0.0
8020,0.2,True,0.02,31,False,vs_right,w,775,91,26,65,715,677,38,0.2857142857142857
8020,0.2,True,0.02,31,False,vs_left,w,775,76,27,49,730,693,37,0.35526315789473684
8020,0.2,True,0.02,31,False,difference,w,775,4,2,2,802,740,62,0.5
8020,0.2,True,0.004,86,True,baseline,b,3500,0,0,0,3528,2464,1064,0.0
8020,0.2,True,0.004,86,True,vs_right,b,3500,52,52,0,3476,2464,1012,1.0
8020,0.2,True,0.004,86,True,vs_left,b,3500,56,56,0,3472,2464,1008,1.0
8020,0.2,True,0.004,86,True,difference,b,3500,0,0,0,3528,2464,1064,0.0
8020,0.2,True,0.004,86,False,baseline,b,10750,0,0,0,10836,9772,1064,0.0
8020,0.2,True,0.004,86,False,vs_right,b,10750,37,7,30,10799,9742,1057,0.1891891891891892
8020,0.2,True,0.004,86,False,vs_left,b,10750,19,9,10,10817,9762,1055,0.47368421052631576
8020,0.2,True,0.004,86,False,difference,b,10750,1,0,1,10835,9771,1064,0.0
8020,0.2,True,0.004,64,True,baseline,b,2250,0,0,0,2268,1584,684,0.0
8020,0.2,True,0.004,64,True,vs_right,b,2250,53,53,0,2215,1584,631,1.0
8020,0.2,True,0.004,64,True,vs_left,b,2250,68,68,0,2200,1584,616,1.0
8020,0.2,True,0.004,64,True,difference,b,2250,0,0,0,2268,1584,684,0.0
8020,0.2,True,0.004,64,False,baseline,b,8000,0,0,0,8064,7380,684,0.0
8020,0.2,True,0.004,64,False,vs_right,b,8000,38,12,26,8026,7354,672,0.3157894736842105
8020,0.2,True,0.004,64,False,vs_left,b,8000,17,10,7,8047,7373,674,0.5882352941176471
8020,0.2,True,0.004,64,False,difference,b,8000,1,0,1,8063,7379,684,0.0
8020,0.2,True,0.004,31,True,baseline,b,1000,0,0,0,1008,704,304,0.0
8020,0.2,True,0.004,31,True,vs_right,b,1000,33,33,0,975,704,271,1.0
8020,0.2,True,0.004,31,True,vs_left,b,1000,42,42,0,966,704,262,1.0
8020,0.2,True,0.004,31,True,difference,b,1000,0,0,0,1008,704,304,0.0
8020,0.2,True,0.004,31,False,baseline,b,3875,0,0,0,3906,3602,304,0.0
8020,0.2,True,0.004,31,False,vs_right,b,3875,38,15,23,3868,3579,289,0.39473684210526316
8020,0.2,True,0.004,31,False,vs_left,b,3875,26,12,14,3880,3588,292,0.46153846153846156
8020,0.2,True,0.004,31,False,difference,b,3875,1,0,1,3905,3601,304,0.0
8020,0.2,True,0.012,86,True,baseline,b,1148,0,0,0,1176,840,336,0.0
8020,0.2,True,0.012,86,True,vs_right,b,1148,35,35,0,1141,840,301,1.0
8020,0.2,True,0.012,86,True,vs_left,b,1148,49,49,0,1127,840,287,1.0
8020,0.2,True,0.012,86,True,difference,b,1148,0,0,0,1176,840,336,0.0
8020,0.2,True,0.012,86,False,baseline,b,3526,0,0,0,3612,3276,336,0.0
8020,0.2,True,0.012,86,False,vs_right,b,3526,37,15,22,3575,3254,321,0.40540540540540543
8020,0.2,True,0.012,86,False,vs_left,b,3526,29,16,13,3583,3263,320,0.5517241379310345
8020,0.2,True,0.012,86,False,difference,b,3526,0,0,0,3612,3276,336,0.0
8020,0.2,True,0.012,64,True,baseline,b,738,0,0,0,756,540,216,0.0
8020,0.2,True,0.012,64,True,vs_right,b,738,30,30,0,726,540,186,1.0
8020,0.2,True,0.012,64,True,vs_left,b,738,43,43,0,713,540,173,1.0
8020,0.2,True,0.012,64,True,difference,b,738,0,0,0,756,540,216,0.0
8020,0.2,True,0.012,64,False,baseline,b,2624,0,0,0,2688,2472,216,0.0
8020,0.2,True,0.012,64,False,vs_right,b,2624,29,13,16,2659,2456,203,0.4482758620689655
8020,0.2,True,0.012,64,False,vs_left,b,2624,33,20,13,2655,2459,196,0.6060606060606061
8020,0.2,True,0.012,64,False,difference,b,2624,0,0,0,2688,2472,216,0.0
8020,0.2,True,0.012,31,True,baseline,b,328,0,0,0,336,240,96,0.0
8020,0.2,True,0.012,31,True,vs_right,b,328,16,16,0,320,240,80,1.0
8020,0.2,True,0.012,31,True,vs_left,b,328,24,24,0,312,240,72,1.0
8020,0.2,True,0.012,31,True,difference,b,328,0,0,0,336,240,96,0.0
8020,0.2,True,0.012,31,False,baseline,b,1271,0,0,0,1302,1206,96,0.0
8020,0.2,True,0.012,31,False,vs_right,b,1271,25,10,15,1277,1191,86,0.4
8020,0.2,True,0.012,31,False,vs_left,b,1271,24,13,11,1278,1195,83,0.5416666666666666
8020,0.2,True,0.012,31,False,difference,b,1271,1,0,1,1301,1205,96,0.0
8020,0.2,True,0.02,86,True,baseline,b,700,0,0,0,728,504,224,0.0
8020,0.2,True,0.02,86,True,vs_right,b,700,28,28,0,700,504,196,1.0
8020,0.2,True,0.02,86,True,vs_left,b,700,44,44,0,684,504,180,1.0
8020,0.2,True,0.02,86,True,difference,b,700,0,0,0,728,504,224,0.0
8020,0.2,True,0.02,86,False,baseline,b,2150,0,0,0,2236,2012,224,0.0
8020,0.2,True,0.02,86,False,vs_right,b,2150,38,17,21,2198,1991,207,0.4473684210526316
8020,0.2,True,0.02,86,False,vs_left,b,2150,55,34,21,2181,1991,190,0.6181818181818182
8020,0.2,True,0.02,86,False,difference,b,2150,1,0,1,2235,2011,224,0.0
8020,0.2,True,0.02,64,True,baseline,b,450,0,0,0,468,324,144,0.0
8020,0.2,True,0.02,64,True,vs_right,b,450,25,25,0,443,324,119,1.0
8020,0.2,True,0.02,64,True,vs_left,b,450,31,31,0,437,324,113,1.0
8020,0.2,True,0.02,64,True,difference,b,450,0,0,0,468,324,144,0.0
8020,0.2,True,0.02,64,False,baseline,b,1600,0,0,0,1664,1520,144,0.0
8020,0.2,True,0.02,64,False,vs_right,b,1600,29,12,17,1635,1503,132,0.41379310344827586
8020,0.2,True,0.02,64,False,vs_left,b,1600,45,27,18,1619,1502,117,0.6
8020,0.2,True,0.02,64,False,difference,b,1600,1,0,1,1663,1519,144,0.0
8020,0.2,True,0.02,31,True,baseline,b,200,0,0,0,208,144,64,0.0
8020,0.2,True,0.02,31,True,vs_right,b,200,14,14,0,194,144,50,1.0
8020,0.2,True,0.02,31,True,vs_left,b,200,13,13,0,195,144,51,1.0
8020,0.2,True,0.02,31,True,difference,b,200,0,0,0,208,144,64,0.0
8020,0.2,True,0.02,31,False,baseline,b,775,0,0,0,806,742,64,0.0
8020,0.2,True,0.02,31,False,vs_right,b,775,21,8,13,785,729,56,0.38095238095238093
8020,0.2,True,0.02,31,False,vs_left,b,775,27,12,15,779,727,52,0.4444444444444444
8020,0.2,True,0.02,31,False,difference,b,775,1,0,1,805,741,64,0.0
8020,0.2,False,0.004,86,True,baseline,w,3500,7,2,5,3521,2459,1062,0.2857142857142857
8020,0.2,False,0.004,86,True,vs_right,w,3500,497,468,29,3031,2435,596,0.9416498993963782
8020,0.2,False,0.004,86,True,vs_left,w,3500,486,463,23,3042,2441,601,0.9526748971193416
8020,0.2,False,0.004,86,True,difference,w,3500,35,31,4,3493,2460,1033,0.8857142857142857
8020,0.2,False,0.004,86,False,baseline,w,10750,8,2,6,10828,9766,1062,0.25
8020,0.2,False,0.004,86,False,vs_right,w,10750,1119,423,696,9717,9076,641,0.3780160857908847
8020,0.2,False,0.004,86,False,vs_left,w,10750,1111,428,683,9725,9089,636,0.3852385238523852
8020,0.2,False,0.004,86,False,difference,w,10750,56,19,37,10780,9735,1045,0.3392857142857143
8020,0.2,False,0.004,64,True,baseline,w,2250,5,0,5,2263,1579,684,0.0
8020,0.2,False,0.004,64,True,vs_right,w,2250,392,352,40,1876,1544,332,0.8979591836734694
8020,0.2,False,0.004,64,True,vs_left,w,2250,355,333,22,1913,1562,351,0.9380281690140845
8020,0.2,False,0.004,64,True,difference,w,2250,11,9,2,2257,1582,675,0.8181818181818182
8020,0.2,False,0.004,64,False,baseline,w,8000,6,0,6,8058,7374,684,0.0
8020,0.2,False,0.004,64,False,vs_right,w,8000,894,314,580,7170,6800,370,0.3512304250559284
8020,0.2,False,0.004,64,False,vs_left,w,8000,842,296,546,7222,6834,388,0.3515439429928741
8020,0.2,False,0.004,64,False,difference,w,8000,39,5,34,8025,7346,679,0.1282051282051282
8020,0.2,False,0.004,31,True,baseline,w,1000,0,0,0,1008,704,304,0.0
8020,0.2,False,0.004,31,True,vs_right,w,1000,182,154,28,826,676,150,0.8461538461538461
8020,0.2,False,0.004,31,True,vs_left,w,1000,159,144,15,849,689,160,0.9056603773584906
8020,0.2,False,0.004,31,True,difference,w,1000,13,7,6,995,698,297,0.5384615384615384
8020,0.2,False,0.004,31,False,baseline,w,3875,6,0,6,3900,3596,304,0.0
8020,0.2,False,0.004,31,False,vs_right,w,3875,462,143,319,3444,3283,161,0.30952380952380953
8020,0.2,False,0.004,31,False,vs_left,w,3875,436,131,305,3470,3297,173,0.30045871559633025
8020,0.2,False,0.004,31,False,difference,w,3875,23,3,20,3883,3582,301,0.13043478260869565
8020,0.2,False,0.012,86,True,baseline,w,1148,0,0,0,1176,840,336,0.0
8020,0.2,False,0.012,86,True,vs_right,w,1148,173,159,14,1003,826,177,0.9190751445086706
8020,0.2,False,0.012,86,True,vs_left,w,1148,178,172,6,998,834,164,0.9662921348314607
8020,0.2,False,0.012,86,True,difference,w,1148,18,14,4,1158,836,322,0.7777777777777778
8020,0.2,False,0.012,86,False,baseline,w,3526,2,0,2,3610,3274,336,0.0
8020,0.2,False,0.012,86,False,vs_right,w,3526,407,155,252,3205,3024,181,0.3808353808353808
8020,0.2,False,0.012,86,False,vs_left,w,3526,385,148,237,3227,3039,188,0.38441558441558443
8020,0.2,False,0.012,86,False,difference,w,3526,12,4,8,3600,3268,332,0.3333333333333333
8020,0.2,False,0.012,64,True,baseline,w,738,0,0,0,756,540,216,0.0
8020,0.2,False,0.012,64,True,vs_right,w,738,131,114,17,625,523,102,0.8702290076335878
8020,0.2,False,0.012,64,True,vs_left,w,738,130,122,8,626,532,94,0.9384615384615385
8020,0.2,False,0.012,64,True,difference,w,738,8,6,2,748,538,210,0.75
8020,0.2,False,0.012,64,False,baseline,w,2624,2,0,2,2686,2470,216,0.0
8020,0.2,False,0.012,64,False,vs_right,w,2624,319,111,208,2369,2264,105,0.34796238244514105
8020,0.2,False,0.012,64,False,vs_left,w,2624,298,109,189,2390,2283,107,0.36577181208053694
8020,0.2,False,0.012,64,False,difference,w,2624,6,0,6,2682,2466,216,0.0
8020,0.2,False,0.012,31,True,baseline,w,328,0,0,0,336,240,96,0.0
8020,0.2,False,0.012,31,True,vs_right,w,328,63,53,10,273,230,43,0.8412698412698413
8020,0.2,False,0.012,31,True,vs_left,w,328,57,53,4,279,236,43,0.9298245614035088
8020,0.2,False,0.012,31,True,difference,w,328,4,2,2,332,238,94,0.5
8020,0.2,False,0.012,31,False,baseline,w,1271,2,0,2,1300,1204,96,0.0
8020,0.2,False,0.012,31,False,vs_right,w,1271,159,50,109,1143,1097,46,0.31446540880503143
8020,0.2,False,0.012,31,False,vs_left,w,1271,153,47,106,1149,1100,49,0.30718954248366015
8020,0.2,False,0.012,31,False,difference,w,1271,10,2,8,1292,1198,94,0.2
8020,0.2,False,0.02,86,True,baseline,w,700,2,0,2,726,502,224,0.0
8020,0.2,False,0.02,86,True,vs_right,w,700,102,92,10,626,494,132,0.9019607843137255
8020,0.2,False,0.02,86,True,vs_left,w,700,87,85,2,641,502,139,0.9770114942528736
8020,0.2,False,0.02,86,True,difference,w,700,4,4,0,724,504,220,1.0
8020,0.2,False,0.02,86,False,baseline,w,2150,0,0,0,2236,2012,224,0.0
8020,0.2,False,0.02,86,False,vs_right,w,2150,213,86,127,2023,1885,138,0.40375586854460094
8020,0.2,False,0.02,86,False,vs_left,w,2150,146,66,80,2090,1932,158,0.4520547945205479
8020,0.2,False,0.02,86,False,difference,w,2150,6,2,4,2230,2008,222,0.3333333333333333
8020,0.2,False,0.02,64,True,baseline,w,450,2,0,2,466,322,144,0.0
8020,0.2,False,0.02,64,True,vs_right,w,450,76,66,10,392,314,78,0.868421052631579
8020,0.2,False,0.02,64,True,vs_left,w,450,68,66,2,400,322,78,0.9705882352941176
8020,0.2,False,0.02,64,True,difference,w,450,0,0,0,468,324,144,0.0
8020,0.2,False,0.02,64,False,baseline,w,1600,0,0,0,1664,1520,144,0.0
8020,0.2,False,0.02,64,False,vs_right,w,1600,168,64,104,1496,1416,80,0.38095238095238093
8020,0.2,False,0.02,64,False,vs_left,w,1600,118,46,72,1546,1448,98,0.3898305084745763
8020,0.2,False,0.02,64,False,difference,w,1600,4,0,4,1660,1516,144,0.0
8020,0.2,False,0.02,31,True,baseline,w,200,2,0,2,206,142,64,0.0
8020,0.2,False,0.02,31,True,vs_right,w,200,38,30,8,170,136,34,0.7894736842105263
8020,0.2,False,0.02,31,True,vs_left,w,200,31,29,2,177,142,35,0.9354838709677419
8020,0.2,False,0.02,31,True,difference,w,200,0,0,0,208,144,64,0.0
8020,0.2,False,0.02,31,False,baseline,w,775,2,0,2,804,740,64,0.0
8020,0.2,False,0.02,31,False,vs_right,w,775,91,28,63,715,679,36,0.3076923076923077
8020,0.2,False,0.02,31,False,vs_left,w,775,66,22,44,740,698,42,0.3333333333333333
8020,0.2,False,0.02,31,False,difference,w,775,4,0,4,802,738,64,0.0
8020,0.2,False,0.004,86,True,baseline,b,3500,0,0,0,3528,2464,1064,0.0
8020,0.2,False,0.004,86,True,vs_right,b,3500,65,65,0,3463,2464,999,1.0
8020,0.2,False,0.004,86,True,vs_left,b,3500,47,47,0,3481,2464,1017,1.0
8020,0.2,False,0.004,86,True,difference,b,3500,0,0,0,3528,2464,1064,0.0
8020,0.2,False,0.004,86,False,baseline,b,10750,0,0,0,10836,9772,1064,0.0
8020,0.2,False,0.004,86,False,vs_right,b,10750,31,10,21,10805,9751,1054,0.3225806451612903
8020,0.2,False,0.004,86,False,vs_left,b,10750,14,6,8,10822,9764,1058,0.42857142857142855
8020,0.2,False,0.004,86,False,difference,b,10750,1,0,1,10835,9771,1064,0.0
8020,0.2,False,0.004,64,True,baseline,b,2250,0,0,0,2268,1584,684,0.0
8020,0.2,False,0.004,64,True,vs_right,b,2250,62,62,0,2206,1584,622,1.0
8020,0.2,False,0.004,64,True,vs_left,b,2250,51,51,0,2217,1584,633,1.0
8020,0.2,False,0.004,64,True,difference,b,2250,0,0,0,2268,1584,684,0.0
8020,0.2,False,0.004,64,False,baseline,b,8000,0,0,0,8064,7380,684,0.0
8020,0.2,False,0.004,64,False,vs_right,b,8000,39,14,25,8025,7355,670,0.358974358974359
8020,0.2,False,0.004,64,False,vs_left,b,8000,12,3,9,8052,7371,681,0.25
8020,0.2,False,0.004,64,False,difference,b,8000,1,0,1,8063,7379,684,0.0
8020,0.2,False,0.004,31,True,baseline,b,1000,0,0,0,1008,704,304,0.0
8020,0.2,False,0.004,31,True,vs_right,b,1000,43,43,0,965,704,261,1.0
8020,0.2,False,0.004,31,True,vs_left,b,1000,51,50,1,957,703,254,0.9803921568627451
8020,0.2,False,0.004,31,True,difference,b,1000,0,0,0,1008,704,304,0.0
8020,0.2,False,0.004,31,False,baseline,b,3875,0,0,0,3906,3602,304,0.0
8020,0.2,False,0.004,31,False,vs_right,b,3875,51,25,26,3855,3576,279,0.49019607843137253
8020,0.2,False,0.004,31,False,vs_left,b,3875,20,11,9,3886,3593,293,0.55
8020,0.2,False,0.004,31,False,difference,b,3875,1,0,1,3905,3601,304,0.0
8020,0.2,False,0.012,86,True,baseline,b,1148,0,0,0,1176,840,336,0.0
8020,0.2,False,0.012,86,True,vs_right,b,1148,40,40,0,1136,840,296,1.0
8020,0.2,False,0.012,86,True,vs_left,b,1148,44,43,1,1132,839,293,0.9772727272727273
8020,0.2,False,0.012,86,True,difference,b,1148,1,1,0,1175,840,335,1.0
8020,0.2,False,0.012,86,False,baseline,b,3526,0,0,0,3612,3276,336,0.0
8020,0.2,False,0.012,86,False,vs_right,b,3526,45,21,24,3567,3252,315,0.4666666666666667
8020,0.2,False,0.012,86,False,vs_left,b,3526,26,14,12,3586,3264,322,0.5384615384615384
8020,0.2,False,0.012,86,False,difference,b,3526,0,0,0,3612,3276,336,0.0
8020,0.2,False,0.012,64,True,baseline,b,738,0,0,0,756,540,216,0.0
8020,0.2,False,0.012,64,True,vs_right,b,738,32,32,0,724,540,184,1.0
8020,0.2,False,0.012,64,True,vs_left,b,738,41,40,1,715,539,176,0.975609756097561
8020,0.2,False,0.012,64,True,difference,b,738,0,0,0,756,540,216,0.0
8020,0.2,False,0.012,64,False,baseline,b,2624,0,0,0,2688,2472,216,0.0
8020,0.2,False,0.012,64,False,vs_right,b,2624,40,16,24,2648,2448,200,0.4
8020,0.2,False,0.012,64,False,vs_left,b,2624,22,12,10,2666,2462,204,0.5454545454545454
8020,0.2,False,0.012,64,False,difference,b,2624,0,0,0,2688,2472,216,0.0
8020,0.2,False,0.012,31,True,baseline,b,328,0,0,0,336,240,96,0.0
8020,0.2,False,0.012,31,True,vs_right,b,328,20,20,0,316,240,76,1.0
8020,0.2,False,0.012,31,True,vs_left,b,328,25,24,1,311,239,72,0.96
8020,0.2,False,0.012,31,True,difference,b,328,0,0,0,336,240,96,0.0
8020,0.2,False,0.012,31,False,baseline,b,1271,0,0,0,1302,1206,96,0.0
8020,0.2,False,0.012,31,False,vs_right,b,1271,34,14,20,1268,1186,82,0.4117647058823529
8020,0.2,False,0.012,31,False,vs_left,b,1271,25,16,9,1277,1197,80,0.64
8020,0.2,False,0.012,31,False,difference,b,1271,2,0,2,1300,1204,96,0.0
8020,0.2,False,0.02,86,True,baseline,b,700,0,0,0,728,504,224,0.0
8020,0.2,False,0.02,86,True,vs_right,b,700,28,28,0,700,504,196,1.0
8020,0.2,False,0.02,86,True,vs_left,b,700,43,42,1,685,503,182,0.9767441860465116
8020,0.2,False,0.02,86,True,difference,b,700,0,0,0,728,504,224,0.0
8020,0.2,False,0.02,86,False,baseline,b,2150,0,0,0,2236,2012,224,0.0
8020,0.2,False,0.02,86,False,vs_right,b,2150,36,21,15,2200,1997,203,0.5833333333333334
8020,0.2,False,0.02,86,False,vs_left,b,2150,42,29,13,2194,1999,195,0.6904761904761905
8020,0.2,False,0.02,86,False,difference,b,2150,0,0,0,2236,2012,224,0.0
8020,0.2,False,0.02,64,True,baseline,b,450,0,0,0,468,324,144,0.0
8020,0.2,False,0.02,64,True,vs_right,b,450,27,27,0,441,324,117,1.0
8020,0.2,False,0.02,64,True,vs_left,b,450,33,32,1,435,323,112,0.9696969696969697
8020,0.2,False,0.02,64,True,difference,b,450,0,0,0,468,324,144,0.0
8020,0.2,False,0.02,64,False,baseline,b,1600,0,0,0,1664,1520,144,0.0
8020,0.2,False,0.02,64,False,vs_right,b,1600,33,15,18,1631,1502,129,0.45454545454545453
8020,0.2,False,0.02,64,False,vs_left,b,1600,34,24,10,1630,1510,120,0.7058823529411765
8020,0.2,False,0.02,64,False,difference,b,1600,0,0,0,1664,1520,144,0.0
8020,0.2,False,0.02,31,True,baseline,b,200,0,0,0,208,144,64,0.0
8020,0.2,False,0.02,31,True,vs_right,b,200,17,17,0,191,144,47,1.0
8020,0.2,False,0.02,31,True,vs_left,b,200,15,14,1,193,143,50,0.9333333333333333
8020,0.2,False,0.02,31,True,difference,b,200,0,0,0,208,144,64,0.0
8020,0.2,False,0.02,31,False,baseline,b,775,0,0,0,806,742,64,0.0
8020,0.2,False,0.02,31,False,vs_right,b,775,26,10,16,780,726,54,0.38461538461538464
8020,0.2,False,0.02,31,False,vs_left,b,775,29,14,15,777,727,50,0.4827586206896552
8020,0.2,False,0.02,31,False,difference,b,775,0,0,0,806,742,64,0.0
